All Muslims should be regarded as terrorists.	US Engagement in the Middle East
The US should pull out of the Middle East.	US Engagement in the Middle East
War with Syria is imminent.	US Engagement in the Middle East
The US needs to let the Middle East solve its own problems.	US Engagement in the Middle East
Middle east countries should be allowed to determine their own future.	US Engagement in the Middle East
US cannot be in isolation.	US Engagement in the Middle East
The war in Iraq was not worth the cost of human life.	US Engagement in the Middle East
US interference in the middle east has hurt US economically.	US Engagement in the Middle East
Withholding funds to Palestinian National Authority prevents anti-Semitism.	US Engagement in the Middle East
Us engagement in the middle east will help keep terrorist cells from growing.	US Engagement in the Middle East
The US should prevent Rusia to support the syrian dictator.	US Engagement in the Middle East
Terrorist groups must be stopped at all costs by the US and its allies combined.	US Engagement in the Middle East
US interference in the middle East has done a lot to destabilize the region.	US Engagement in the Middle East
US interference in the middle East increases antisemitism and Islamic racism.	US Engagement in the Middle East
The war in the middle east wastes military resources.	US Engagement in the Middle East
US needs to strengthen its allies in the Middle East.	US Engagement in the Middle East
The war with Iraq was pointless and very costly.	US Engagement in the Middle East
US waste millions everyday in a struggling economy.	US Engagement in the Middle East
Us engagement in the middle east is controversial in the world and brings a lot of hatred and anti US sentiment to the US.	US Engagement in the Middle East
United States must seek more potential allies.	US Engagement in the Middle East
The US should support humanitarian groups in the middle East.	US Engagement in the Middle East
US is not the police of the world.	US Engagement in the Middle East
USA had to protect their allies.	US Engagement in the Middle East
Stop spending money in other countries and spend it in our own.	US Engagement in the Middle East
The US should try to keep themselves safe.	US Engagement in the Middle East
The Us should try to protect themselve.	US Engagement in the Middle East
US has to take the lead in global leadership.	US Engagement in the Middle East
The US should not engage in further warfare in the Middle East.	US Engagement in the Middle East
US should leave Iraq.	US Engagement in the Middle East
Us engagement in the middle east will help legitimate governments prevail.	US Engagement in the Middle East
US interference in the middle East increases antisemitism.	US Engagement in the Middle East
The U.S. has interferred in issues unrelated to us and we have been informed that we are not wanted.	US Engagement in the Middle East
The USA is doing more more harm than good in the middle east by harming innocent civilians.	US Engagement in the Middle East
American should stop the dispute in the middle east.	US Engagement in the Middle East
Usa's intervention in middle east should be discussed with the Country before act.	US Engagement in the Middle East
Inclusion with warring in other countries does turn our friends foe into ours.	US Engagement in the Middle East
The US has to show strength in the Middle East to prevent terrorism.	US Engagement in the Middle East
Forcing beliefs on established Middle East cultures will only cause negative reactions.	US Engagement in the Middle East
Reducing ISIS activity is a responsibility of the Us.	US Engagement in the Middle East
ISIS must be destroyed at all cost.	US Engagement in the Middle East
America's involvement in the Middle East has lead to increased terrorism.	US Engagement in the Middle East
Sending troops is not helpful if we are not wanted there.	US Engagement in the Middle East
America should not send troops to the middle east.	US Engagement in the Middle East
Troops should not be sent to the Middle East.	US Engagement in the Middle East
The u.s. should not 'take sides' in middle east conflicts.	US Engagement in the Middle East
US should not interfere Palestinian fight with Israel.	US Engagement in the Middle East
The USA should not send any military to Iraq.	US Engagement in the Middle East
The US should not interfere in the politics of the Middle East.	US Engagement in the Middle East
Those in the Middle East feel the US has butted in where it doesn't belong.	US Engagement in the Middle East
The USA has the military force to intervene in the Middle East so they should use it.	US Engagement in the Middle East
The U.S. should not accept any Muslim refugees.	US Engagement in the Middle East
Before any compromise there must be a correct dialogue.	US Engagement in the Middle East
There are many mixed feelings about US Engagement in the middle east.	US Engagement in the Middle East
Sending troops to the Middle East causes more problems than it solves.	US Engagement in the Middle East
The war is not helping anybody middle east nor america.	US Engagement in the Middle East
The war in Iraq is wasting money.	US Engagement in the Middle East
War in Middle East is too expensive for the US.	US Engagement in the Middle East
The war in the Middle East is about oil.	US Engagement in the Middle East
Sending troops to the Middle East does not prevent terrorism.	US Engagement in the Middle East
The US needs to take a hard stand on terrorism.	US Engagement in the Middle East
Aiding in trying to secure lives in Iraq is worth the cost of helping them.	US Engagement in the Middle East
ISIS is a direct result of the US involvement in the Middle East.	US Engagement in the Middle East
If lives can be saved then our assistance in Iraq is warranted.	US Engagement in the Middle East
The US should focus on what is good for the middle East not what is good for us.	US Engagement in the Middle East
USA interference in the middle east will only cause north koreea creating new measures of war.	US Engagement in the Middle East
We must show we are strong.	US Engagement in the Middle East
The U.S. should not favor Israel over Palestine.	US Engagement in the Middle East
US should protect America against terrorism.	US Engagement in the Middle East
Iraq was better off before the u.s. invaded and took down hussein.	US Engagement in the Middle East
Us should withdraw troops from middle east.	US Engagement in the Middle East
USA is engaging in the middle east because they are alies with saudi arabia.	US Engagement in the Middle East
America should not send ground troops to the middle east.	US Engagement in the Middle East
The american public will not support further military engagement in the middle east.	US Engagement in the Middle East
US Engagement in the middle east has also helped some people in the middle east.	US Engagement in the Middle East
The Iraq war has cost too many American lives.	US Engagement in the Middle East
The Iraq war is proof that the US should stay away from the Middle East.	US Engagement in the Middle East
The terrorists will attack united state as a consequence of interference.	US Engagement in the Middle East
We must spread democracy to the Middle East.	US Engagement in the Middle East
Unfortunately trying to help has caused disdain for the West.	US Engagement in the Middle East
America should not engage with the middle east.	US Engagement in the Middle East
Usa's engagement in middle east is not a public interest topic.	US Engagement in the Middle East
The US should leave the middle east alone.	US Engagement in the Middle East
US should stop engaging middle east conflict.	US Engagement in the Middle East
The war in Iraq was worth the costs.	US Engagement in the Middle East
The military should be sent home from the middle east.	US Engagement in the Middle East
The USA should be concerned with terrorists entering the usa.	US Engagement in the Middle East
Middle East should be left alone.	US Engagement in the Middle East
Terrorist are dominating the middle East since the war.	US Engagement in the Middle East
ISIS operations should be reduce by a more powerful force.	US Engagement in the Middle East
The U.S. should take an isolationist approach and not engage.	US Engagement in the Middle East
We cannot make any irrational decisions about US Engagement in the middle east.	US Engagement in the Middle East
The US needs to stay away from the Middle East.	US Engagement in the Middle East
The ongoing conflict in the Middle East justifies United States assistance.	US Engagement in the Middle East
War in the Middle East creates more terrorism.	US Engagement in the Middle East
Usa's intervention in middle east can bring a disaster.	US Engagement in the Middle East
Middle Eastern people are the same as United States citizens.	US Engagement in the Middle East
It is important to protect oil producers in the Middle East.	US Engagement in the Middle East
Engaging in the Middle East only fuels terrorism.	US Engagement in the Middle East
It is our duty to spread Western ideals to the Middle East.	US Engagement in the Middle East
It is sensible to withhold funding from groups that go against our country's moral such as anti-semitism.	US Engagement in the Middle East
Not every middle eastern is a terrorist.	US Engagement in the Middle East
The US should worry about their problems first.	US Engagement in the Middle East
USA's interference in middle east politics resulted in an entire generation that has been turned against the West.	US Engagement in the Middle East
The war in Iraq was a war for oil not bad intelligence.	US Engagement in the Middle East
United States must prove to be a strong power.	US Engagement in the Middle East
The war in Iraq was not worth the financial burden placed on the US economy.	US Engagement in the Middle East
Most of the US attacks in the Middle East harm civilians more than terrorists.	US Engagement in the Middle East
Eliminate as many weapons of mass destruction as possible.	US Engagement in the Middle East
The US should always support Israel.	US Engagement in the Middle East
We must contain Iran.	US Engagement in the Middle East
Because of engagement in the middle east US credibility is on the line.	US Engagement in the Middle East
Regime change in the Middle East leads to bigger problems.	US Engagement in the Middle East
Us engagement in the middle east will assist legitimate governments from being overrun by terrorist.	US Engagement in the Middle East
United States should maximize.	US Engagement in the Middle East
It is needed to send more troops to syria.	US Engagement in the Middle East
U.s. military engagement in the middle east is increasing the threat of terrorism.	US Engagement in the Middle East
The US should continue to conduct humanitarian efforts in the Middle East.	US Engagement in the Middle East
US must stop aiding Israel to avoid conflict with other middle eastern countries.	US Engagement in the Middle East
As a political super power the USA should use it's power to protect itself and allies from the Middle East.	US Engagement in the Middle East
War in Iraq is not worth it.	US Engagement in the Middle East
US Engagement in the middle east needs to be carefully addressed.	US Engagement in the Middle East
Americans should not send groud troops to the middle east.	US Engagement in the Middle East
US has to participate in the Middle East to monitor and prevent terrorism.	US Engagement in the Middle East
The war in Iraq was started under false pretenses.	US Engagement in the Middle East
USA has the right to bomb ISIS.	US Engagement in the Middle East
The US needs to show its support for Israel by moving its embassy to Jerusalem. It would make a big statement to the world .	US Engagement in the Middle East
US alies US capabilities to get trained against terrorists.	US Engagement in the Middle East
Acceptance of differences in Middle Eastern cultures is paramount in resolving current conflict.	US Engagement in the Middle East
The United States is in a place of power to help resolve problems in the Middle East.	US Engagement in the Middle East
The US shouldn't bother those people.	US Engagement in the Middle East
President Trump should not provide a timeline for troops but should not increase troops.	US Engagement in the Middle East
Iraq posses no threat to United states.	US Engagement in the Middle East
United States must avoid the least action that leads to war.	US Engagement in the Middle East
US participation in the Middle East can open more diplomacy opportunities.	US Engagement in the Middle East
They should fulfill their commitments to peace and harmony.	US Engagement in the Middle East
US should support the middle east with more resources to prevent terrorism.	US Engagement in the Middle East
America  should deal with the problems in their own country before interfering int he Middle East.	US Engagement in the Middle East
If Israel did not exist it would solve all of the problems in the Middle East.	US Engagement in the Middle East
Gun ownership may deter crime.	Gun Rights
Owning a gun can deter criminals.	Gun Rights
Only officers should carry a weapon.	Gun Rights
There are legitimate reasons for people owning guns.	Gun Rights
Civilians should not poses gun.	Gun Rights
Guns are sometimes used in self defense.	Gun Rights
Having guns is a protection against robbers.	Gun Rights
Guns should be limited.	Gun Rights
Celebrities, such as Rosie O'Donnel who has a security detail but wants to take guns away from average citizens, should practice what they preach.	Gun Rights
Many people are responsible gun owners.	Gun Rights
People should be allowed to own as many guns as they want.	Gun Rights
Not every one must have a gun.	Gun Rights
Owning guns is a fundamental right.	Gun Rights
Gun restrictions leave the citizens open to abuse from the government, and leave them vulnerable for a fully police state.	Gun Rights
Use of guns must be prohibited among some age groups.	Gun Rights
Guns pose a threat in families.	Gun Rights
Too much guns in circulation can kill alot.	Gun Rights
In a certain part to eliminate the arms would be to end the delinquency.	Gun Rights
Guns should be legal for everyone.	Gun Rights
Guns increase murders.	Gun Rights
Anyone should be able to own a gun.	Gun Rights
Guns should be registered.	Gun Rights
While it might be reasonable for individuals to own handguns, the ownership of semi-automatic guns should be restricted.	Gun Rights
People should not be allowed to conceal carry without a permit.	Gun Rights
Open carry deters violence.	Gun Rights
Guns can be stored safely at home.	Gun Rights
Guns possessions should be reduced.	Gun Rights
Guns are a protection against political tyranny.	Gun Rights
Gun owners need to be required to have a background check.	Gun Rights
Illegal guns should be eliminated.	Gun Rights
Gun rights is part of being american.	Gun Rights
Should be able to carry whatever gun you want whenerever.	Gun Rights
Gun rights are apart of our freedom.	Gun Rights
Banning guns only makes people more vulnerable.	Gun Rights
Gun ownership is too highly regulated.	Gun Rights
All Guns should be banned.	Gun Rights
Guns don't kill people, people do.	Gun Rights
Handguns are required for symbolic reasons.	Gun Rights
Gun ownership should not be banned altogether.	Gun Rights
Guns are rarely used For Defense purpose.	Gun Rights
Guns should only be used if there are no other options.	Gun Rights
Everyone should own a gun.	Gun Rights
The gun industry is too heavily regulated.	Gun Rights
Gun owners should be required to take a gun safety course.	Gun Rights
Banning guns is a violation of the 2nd amendment.	Gun Rights
The possession of free weapons would increase the mortality rate in society.	Gun Rights
Guns are rarely used in self defense.	Gun Rights
Guns should be locked up when not in hunting season.	Gun Rights
Guns are cool.	Gun Rights
Gun owners should only be able to carry 1 weapon on their person.	Gun Rights
We should evaluate who can carry a weapon.	Gun Rights
Guns are necessary.	Gun Rights
Gun control is a must.	Gun Rights
Guns are dangerous to civilians.	Gun Rights
Guns per capita should be monitored.	Gun Rights
There should be a more strict background check for buyign a gun.	Gun Rights
It is dangerous to own a gun.	Gun Rights
Guns are legitimately used for hunting.	Gun Rights
Guns are also used in hunting.	Gun Rights
You shouldn't have to register every gun.	Gun Rights
Gun ownership leads to unnecessary killings.	Gun Rights
The founding fathers intended for the military to have the right to bear arms, not ordinary citizens.	Gun Rights
No Guns should be banned.	Gun Rights
Criminals don't obey laws.	Gun Rights
Gun ownership can be responsible and regulated.	Gun Rights
Gun ownership deters crime.	Gun Rights
Circulation of gun should be limited.	Gun Rights
Gun ownership should be reduced.	Gun Rights
This issue is about the kind of the amount of and under what circumstances citizens are allowed to possess and bear guns.	Gun Rights
Gun owners should be registered.	Gun Rights
A gun in a household is dangerous for children.	Gun Rights
People who have a lot of guns sometimes become murders.	Gun Rights
Everyone should support the 2nd amendment.	Gun Rights
Widespread gun ownership leads to mass killings.	Gun Rights
Handguns should be allowed for everyone.	Gun Rights
When tension mounts, it will eventually erupt in the most unpleasant of ways.	Gun Rights
Guns help protect families.	Gun Rights
Criminals will circumvent gun laws.	Gun Rights
There should be limits on automatic weapons.	Gun Rights
What circumstances citizens are allowed to possess and bear guns.	Gun Rights
Banning guns is like banning forks in an attempt to stop making people fat.	Gun Rights
Guns should be only allowed to the military.	Gun Rights
We should teach people from an early age the damage that they can do, how to properly and safely use them.	Gun Rights
The people who use guns for crimes usually obtain them illegally anyways.	Gun Rights
Weapons are necessary to defend ourselves.	Gun Rights
Gun ownership only reasserts violence.	Gun Rights
People must be trained before to buy a gun.	Gun Rights
Gun owners should have to pass a psych evaluation every year.	Gun Rights
Handguns are required for symbolic reasons -- as a defence against the state monopoly of power.	Gun Rights
Background should be checked carefully before giving selling arms to them.	Gun Rights
All guns should be registered.	Gun Rights
Guns are much less likely to attempt a crime.	Gun Rights
Automatic weapons with high capacity magazines are involved in nefarious acts and crimes.	Gun Rights
There should be no restrictions on gun laws.	Gun Rights
Guns should act like a means of defence.	Gun Rights
Guns can too easily fall into the wrong hands.	Gun Rights
Gun registration laws should increase.	Gun Rights
Gun owners should register their arms.	Gun Rights
If guns are outlawed, only outlaws will have guns.	Gun Rights
Gun owners should be required to take a safety test.	Gun Rights
Criminals will always find a way to have a gun.	Gun Rights
High-capacity magazines should be banned.	Gun Rights
The use of weapons must be regulated or eliminated.	Gun Rights
The numbers of guns owned should be limited.	Gun Rights
Guns are used in self defense in the home.	Gun Rights
Banning guns won't prevent criminals from acquiring them.	Gun Rights
Restrictions on gun ownership will only encourage outlaws to have heavy ammunition and high calibre weapons.	Gun Rights
People with a history of gun violence should not be allowed to own firearms.	Gun Rights
Gun ownership is protected in the constitution.	Gun Rights
Guns are a form of protection not a form of mass mudering.	Gun Rights
Guns can help ward off criminal acts.	Gun Rights
Guns should only be issued for hunting.	Gun Rights
Guns should be heavily regulated.	Gun Rights
Childredns are dying at schools because of guns usage.	Gun Rights
Although guns are to be a great aid for self-defense this is not a typical usage by gun owners and guns.	Gun Rights
High-capacity magazines should be banned because they too often turn murder into mass murder.	Gun Rights
Gun rights are necessary.	Gun Rights
Guns should be allowed just for law enforcement and army,navy,etc.	Gun Rights
Guns are part of our history.	Gun Rights
Gun ownership should not be limited.	Gun Rights
Gun owners should be imprisoned if they don't follow applicable laws.	Gun Rights
Guns are rarely used in self-defense.	Gun Rights
Gun owners should only be able to carry a certain amount of ammunition.	Gun Rights
All guns should be licensed.	Gun Rights
Most mass shootings involve guns that were obtained illegally.	Gun Rights
Gun ownership should be very closely regulated.	Gun Rights
People who own guns are not more likely to mass kill.	Gun Rights
Handgun ownership is not only symbolic but is a right of the American people.	Gun Rights
Owning guns should be a right but monitored.	Gun Rights
We don't need more and/or tighter gun control.	Gun Rights
Gun licenses should include a mental health evaluation.	Gun Rights
Guns are a vital form of protection for people.	Gun Rights
We should take off guns from streets.	Gun Rights
The NRA holds guns as a symbol of our right to protect themselves and others in various instances in which safety is threatened.	Gun Rights
Guns aren't the only weapons that kill. Timothy McVeigh used a rental truck and fertilizer.	Gun Rights
Guns aren't promoting safety.	Gun Rights
Gun owners must be registered.	Gun Rights
Guns can be used in self-defense.	Gun Rights
People with mental issues whould not be allowed to carry guns.	Gun Rights
Evaluate rights and duties when carrying a weapon.	Gun Rights
Gun owners should be required to complete training on the appropriate use of the firearms they own.	Gun Rights
Majority of mass murders use legal weapon.	Gun Rights
Owning a gun makes people feel much safer in their home.	Gun Rights
Guns within the city can be hazardous.	Gun Rights
Gun owners should limit their arms.	Gun Rights
Marijuana has been proven to help with migraines.	Legalization of Marijuana
Legalizing marijuana use allows police authorities focus on other crimes.	Legalization of Marijuana
Decriminalizing marijuana redirects the profit from the black market to government funding.	Legalization of Marijuana
Legalization of marijuana would increase the index of delinquency.	Legalization of Marijuana
The consumption on marijuana can lead to more serious drug use.	Legalization of Marijuana
Marijuana is and should be illegal. End of conversation.	Legalization of Marijuana
There is nothing wrong with marijuana.	Legalization of Marijuana
If cigarettes are legal Marijuana should be to because marijuana  is healthier  for you than tobacco.	Legalization of Marijuana
Government should not approve the legalization of Marijuana.	Legalization of Marijuana
Marijuana should be as readily available as cigarettes are.	Legalization of Marijuana
Overuse of marijuana can be problematic.	Legalization of Marijuana
Marijuana is not healthy.	Legalization of Marijuana
Marijuanna use can help cope with stress.	Legalization of Marijuana
Legalization of marijuana can entail encouragement and may cause people to recklessly engage in other illegal drugs.	Legalization of Marijuana
Legalizing marijuana would keep individual states from violating the federal law.	Legalization of Marijuana
Expanding marijuana legality encourages illegal use.	Legalization of Marijuana
Legalizing marijuana lowers crime (no dealers etc.).	Legalization of Marijuana
Marijuana use can help people suffering from pain or chronic illness.	Legalization of Marijuana
Cannabis is nontoxic.	Legalization of Marijuana
Marijuana could help people with eating disorders.	Legalization of Marijuana
Marijuana use will not increase just because it is legalized.	Legalization of Marijuana
Marijuana is fun.	Legalization of Marijuana
Allowing the legal use of marijuana will prevent drug dealers from selling it.	Legalization of Marijuana
Marijauna kills brain cells.	Legalization of Marijuana
Legalizing marijuana reduces the prison population.	Legalization of Marijuana
It is impossible to overdose on marijuana.	Legalization of Marijuana
Marijuana has some effective uses.	Legalization of Marijuana
Those that are capable of responsible usage in regards to medicinal purposes should be allowed access to legal marijuana.	Legalization of Marijuana
Marijuana use is less dangerous than alcohol use.	Legalization of Marijuana
Marijuana alleviates the suffering of people with chronic diseases.	Legalization of Marijuana
Keeping marijuana illegal just leads to increased police efforts to stop the use of the drug.	Legalization of Marijuana
Marijuana smoking is an offence.	Legalization of Marijuana
Legalization of marijuana will result to people not pushing hard drugs.	Legalization of Marijuana
Marijuana should be denied to people.	Legalization of Marijuana
Marijuana is addictive.	Legalization of Marijuana
No drugs at all should be legalized.	Legalization of Marijuana
Medical marijuana can benefit terminally ill.	Legalization of Marijuana
Cannabis saves lives.	Legalization of Marijuana
Marijuana can help cancer patients feel better.	Legalization of Marijuana
Marijuana should be made legal.	Legalization of Marijuana
Legalization may make it appear that drugs are more acceptable for recreational usage.	Legalization of Marijuana
Marijuana should be legalized and approve for medical issues.	Legalization of Marijuana
Marijuana helps suffering of diseases.	Legalization of Marijuana
Marijuana has helped several incurable diseases.	Legalization of Marijuana
Marijuana can be used strictly for medical use of relieving pain.	Legalization of Marijuana
The sale of Marijuana can help boost the economy.	Legalization of Marijuana
Legalization can cause competition with people in places where it is illegal.	Legalization of Marijuana
Policing marijuana is not worth the effort and has led to brutality.	Legalization of Marijuana
Marijuana legalisation can be hazardous.	Legalization of Marijuana
Legalization won’t lead to increased use.	Legalization of Marijuana
Proper administration and monitoring of marijuana can keep use safe and useful.	Legalization of Marijuana
Marijuana causes damage to the Brain.	Legalization of Marijuana
Marijuana can be used to treat physical and mental conditions.	Legalization of Marijuana
The benefits of the criminalization of marijuana are minuscule to nonexistent.	Legalization of Marijuana
The government should not promote the use of marijuna.	Legalization of Marijuana
Marijuana can help with a number of health conditions.	Legalization of Marijuana
Marijuana has side effects.	Legalization of Marijuana
Making cannabis illegal has not discouarged its use.	Legalization of Marijuana
Legalization should conly occur once laws surrounding when and where marijuana use is allowed are established.	Legalization of Marijuana
Marijuana is a gateway drug.	Legalization of Marijuana
The whole process is of legalisation could have adverse effects on the masses.	Legalization of Marijuana
Marijuana helps glaucoma patients deal with their sight issues.	Legalization of Marijuana
Marijuana alleviates the suffering of people with chronic diseases. .	Legalization of Marijuana
The government should legalize marijuana nationwide.	Legalization of Marijuana
Marijuana has many health benefits that have yet to be explored.	Legalization of Marijuana
Legalizing marijuana can allow another tax revenue.	Legalization of Marijuana
Marijuana helps some people out in life.	Legalization of Marijuana
Marijuana would cost society less if it were legal because the government could control the quality.	Legalization of Marijuana
Legalization of Marijuana will result in an increase of Stoned Driving and Related Cases.	Legalization of Marijuana
Marijuana causes memory loss.	Legalization of Marijuana
Legalizing marijuana increases revenue for states.	Legalization of Marijuana
Marijuana is less harmful than other drugs (such as alcohol).	Legalization of Marijuana
Marijuana helps treat a number of diseases.	Legalization of Marijuana
Legalizing marijuana will keep people out of jail.	Legalization of Marijuana
Marijuana is not just a recreational drug.	Legalization of Marijuana
People who smoke marijuana perform just as well at their jobs as people who don't smoke marijuana.	Legalization of Marijuana
Marijuana should be completely legal but subject to the same rules as liquor.	Legalization of Marijuana
Legalization of Marijuana should not be approved.	Legalization of Marijuana
Marijuana prohibition has proved ineffective at preventing marijuana usage.	Legalization of Marijuana
There have been no overdoses or risks with the use of marijuana.	Legalization of Marijuana
Legalizing marijuana helps people with chronic pain.	Legalization of Marijuana
No one is harmed in the consumption of marijuana.	Legalization of Marijuana
Cannabis has medical properties.	Legalization of Marijuana
Legalizing marijuana will stimulate the local economy.	Legalization of Marijuana
Marijuana is bad for your health.	Legalization of Marijuana
Expanding the legal use of marijuana makes the illegal use easier.	Legalization of Marijuana
People with chronic illness have benefited by the use of Marijuana.	Legalization of Marijuana
Legal authorities will benefit from legalizing marijuana as it will reduce illegal use and prosecutions.	Legalization of Marijuana
Legalization of marijuana promotes violence in the streets.	Legalization of Marijuana
Legalizing marijuana removes the forbidden fruit factor of its use.	Legalization of Marijuana
The Founding Fathers grew and smoked hemp.	Legalization of Marijuana
Marijuana is incorrectly labelled as a Class 1 Narcotic.	Legalization of Marijuana
Promoting the use of marijuana will increase damage of human brain.	Legalization of Marijuana
Marijuana should be legalized for medical purposes only.	Legalization of Marijuana
Freely available marijuana condones its recreational use.	Legalization of Marijuana
Marijuana is recognized in the medical profession as an aid for the greatly sick people.	Legalization of Marijuana
Marijuana is less harmful than consuming legal substances such as alcohol or tobacco.	Legalization of Marijuana
Drug abuse can kill.	Legalization of Marijuana
Legalizing marijuana opens a new market and strengthens the economy.	Legalization of Marijuana
Marijuana can be harmful.	Legalization of Marijuana
Legalizing medical maraijuana creates a new tax base.	Legalization of Marijuana
Legalizing marijuana would make it safer because the production process would be regulated.	Legalization of Marijuana
Marijuana should be legailzed.	Legalization of Marijuana
Marijuana eases pain.	Legalization of Marijuana
The accepatance of legal marijuana can cause people to become lax in other drug use.	Legalization of Marijuana
Decriminalizing marijuana can lead to decreased crime rates.	Legalization of Marijuana
Marijuana use can lead to other drug use.	Legalization of Marijuana
Legalization of marijuana removes the profit incentive for drug cartels.	Legalization of Marijuana
Prohibition has enormous social costs.	Legalization of Marijuana
Marijuana has medical benefits.	Legalization of Marijuana
Cannabis is not physically addictive.	Legalization of Marijuana
Freely available marijuana encourages recreational use.	Legalization of Marijuana
Marijuana as being legal can create a delusion with young people that it is okay and may lead to extensive drug use.	Legalization of Marijuana
Legalization of Marijuana will be very important to sick people.	Legalization of Marijuana
Marijuana users have a greater risk of having children with ADD and other similar conditions.	Legalization of Marijuana
Medicinal marijuana should be legalized.	Legalization of Marijuana
Marijuana should be scarce.	Legalization of Marijuana
Exceptions should be considered allow people with medical issues that will benefit from legalization of Marijuana.	Legalization of Marijuana
Marijuana could cause harm to society.	Legalization of Marijuana
Marijuana is not a drug.	Legalization of Marijuana
Marijuana is a less dangerous drug than alcohol.	Legalization of Marijuana
Medical marijuana can aid in methods that do not improve health.	Legalization of Marijuana
Marijuana use is less addictive than tobacco use.	Legalization of Marijuana
Promoting any drugs can be a gateway to harder drugs.	Legalization of Marijuana
Marijuana should be discouraged.	Legalization of Marijuana
There is no correlation between marijuana use and harder drug use.	Legalization of Marijuana
Legalization of Marijuana is good for the economy.	Legalization of Marijuana
Making marijuana legal limits issues of crossing state lines.	Legalization of Marijuana
Legalization results in a reduction in the Business for Drug Dealers (Including Terrorists).	Legalization of Marijuana
Legalizing medical marijuana will reduce illegal sale of marijuana.	Legalization of Marijuana
Legalizing marijuana will make it easier for people to become addicted to it.	Legalization of Marijuana
The government should discourage any drug usage.	Legalization of Marijuana
If Marijuana gets legalized it should pay big amounts of taxes.	Legalization of Marijuana
Legalizing marijuana creates a danger of second-hand smoke to Bystanders.	Legalization of Marijuana
Cannabis has legitimate medical effects.	Legalization of Marijuana
Marijuana is proven to have medical benefits.	Legalization of Marijuana
People who use marijuana are mentally stuck at the age they were when they began using the drug.	Legalization of Marijuana
Marijuana is safer than cigarettes and alcohol.	Legalization of Marijuana
Racists should be sentenced to jail terms.	Black Lives Matter
This country is equal despite what black people want to believe.	Black Lives Matter
Police racial profiling reduces minorities to the status of second class citizens.	Black Lives Matter
The cops should be forced to stop.	Black Lives Matter
Racial discrimination reveals the social backwardness of a society.	Black Lives Matter
What is worse that blacks themselves are falling into racism too.	Black Lives Matter
Not every issue is a race issue and many races face discrimination.	Black Lives Matter
Racism is out of date.	Black Lives Matter
Black people are not inferior and need to stop thinking that way.	Black Lives Matter
Racism should be fought.	Black Lives Matter
All men are created equal.	Black Lives Matter
Black people are often profiled when it comes to criminal matters.	Black Lives Matter
Not all people are equal.	Black Lives Matter
This issues comprises issues of racial profiling and police brutality.	Black Lives Matter
All people are the same regardless of race.	Black Lives Matter
All humans are equal, no matter their race.	Black Lives Matter
Environment inequality still exists for black communities forced to live near chemical plants.	Black Lives Matter
Racial equality is a must.	Black Lives Matter
There must be respect for all races.	Black Lives Matter
Black people are 4 times more likely to attack whites and Hispanics, than whites and Hispanics are to blacks.	Black Lives Matter
Inclusion is a giant step towards a better society.	Black Lives Matter
Police need to be educated on profiling and deescalation techniques.	Black Lives Matter
We are all equal and deserve to be treated as such.	Black Lives Matter
Discrimination with blacks causes degredation of one's self.	Black Lives Matter
There must be equality.	Black Lives Matter
United States criminal justice system.	Black Lives Matter
People should not be discriminated for their skin color.	Black Lives Matter
Both black and white people need to treat authorities with respect.	Black Lives Matter
Individual instances of discrimination are a bigger concern than discrimination against black people.	Black Lives Matter
Although it has declined African Americans are still mistreated.	Black Lives Matter
Racial profiling disparages those it effects.	Black Lives Matter
Black opinions matter.	Black Lives Matter
The us government must try to treat everyone equally.	Black Lives Matter
Every race has experienced racism.	Black Lives Matter
Discrimination against black people still exists.	Black Lives Matter
People in any profession can be racist.	Black Lives Matter
Racial inequality does not only discriminate against one race.	Black Lives Matter
Individual instances of discrimination.	Black Lives Matter
Equality for all is a matter of human rights.	Black Lives Matter
Everybody's life matters.	Black Lives Matter
Black people are 58% of those killed by private citizens by self defence, except 75% of them were killed by other blacks.	Black Lives Matter
Most crime against blacks is not from the police.	Black Lives Matter
No lives should be lost.	Black Lives Matter
Racial profiling has gotten better.	Black Lives Matter
The Black Lives Matter movement encourages racial hate.	Black Lives Matter
Blacks are creative.	Black Lives Matter
The world needs to know that blacks are also humans.	Black Lives Matter
Black lives matter activists are also racist.	Black Lives Matter
People should be treated equally regardless of the skin color.	Black Lives Matter
This country has done nothing to achieve racial equality.	Black Lives Matter
All people are equal regardless of their race.	Black Lives Matter
Skin color is not important.	Black Lives Matter
Racial profiling affects minorities.	Black Lives Matter
All cases of discrimination are important, but racial discrimination must be addressed primarily.	Black Lives Matter
We can all make a better world if we work together.	Black Lives Matter
The USA has worked hard enough to fight racial inequality.	Black Lives Matter
Racial equality is necessary.	Black Lives Matter
Lots of innocently killed blacks have been kids lately.	Black Lives Matter
The country has already done enough to achieve racial equality.	Black Lives Matter
Black people blame everything on their race.	Black Lives Matter
Black people cannot be racist because they aren't in a position of power.	Black Lives Matter
Police brutality should not be allowed in the US.	Black Lives Matter
Discrimination is really bad.	Black Lives Matter
Black people are humans too.	Black Lives Matter
All people should be treated equally regardless of race and color of the skin.	Black Lives Matter
The police looks for blacks to be thieves.	Black Lives Matter
Martin luther king suffered in the flesh this kind of discrimination.	Black Lives Matter
Black should not maltreated.	Black Lives Matter
Black lives matter is taken seriously in the US.	Black Lives Matter
All races do not have equal access to resources and opportunities.	Black Lives Matter
Non white individuals should be treated the same as white.	Black Lives Matter
Historically in the United States there has been discrimination.	Black Lives Matter
Every human is equal.	Black Lives Matter
All races have an equal access to resources.	Black Lives Matter
Racial discrimination has increased over the years.	Black Lives Matter
The electoral college is suspect.	Black Lives Matter
Police racial profiling reduces minorities.	Black Lives Matter
This Is more Of a Movement for Attention, and obviously more money.	Black Lives Matter
Racial profiling is bad.	Black Lives Matter
All white people are racist because of their privilege.	Black Lives Matter
All lives matter.	Black Lives Matter
The greater inequality in a smaller society is the democratic quality of its institutions.	Black Lives Matter
Blacks too must be given priveledges with whites.	Black Lives Matter
The population is not out to get black people.	Black Lives Matter
Any abuse is not acceptable.	Black Lives Matter
Black people still make up a disproportionate share of the prison community.	Black Lives Matter
Black is as important as white.	Black Lives Matter
Discrimination must be severely penalized.	Black Lives Matter
The black lives matter movement is blown out of proportion.	Black Lives Matter
Racists should be punished.	Black Lives Matter
More importance should be placed on blacks.	Black Lives Matter
Black people are unfairly discriminated against.	Black Lives Matter
Discrimination in the usa is a serious issue and needs to be addressed.	Black Lives Matter
Racial discrimination should not be tolerated.	Black Lives Matter
Police profiling is wrong.	Black Lives Matter
The US is not only for white people.	Black Lives Matter
Black lives matter calls for violence against police.	Black Lives Matter
The government needs to do more to stop racism.	Black Lives Matter
Not all races in the usa have equal rights like they should.	Black Lives Matter
Every one has the same rights.	Black Lives Matter
Being racist should be fined.	Black Lives Matter
Blacks are the scum of society.	Black Lives Matter
Black people complain too much.	Black Lives Matter
The world would be safer without black people.	Black Lives Matter
Government should enforced severe punishment against racial profiling.	Black Lives Matter
Black people don't matter any more than anybody else.	Black Lives Matter
There is such thing as racial profiling.	Black Lives Matter
Racial discrimination must be attacked with apprehension.	Black Lives Matter
It would take 40 years for white people to kill as many black people as blacks have killed.	Black Lives Matter
Black people are as human as white people.	Black Lives Matter
All people are good.	Black Lives Matter
Everyone is equal.	Black Lives Matter
Blacks should be regarded.	Black Lives Matter
Black people have been mistreated more by the police.	Black Lives Matter
Everyone should have access to financial success, regardless of skin color.	Black Lives Matter
Rather then just focusing on black people all races need to be treated equal.	Black Lives Matter
The legal system needs to punish cops that take advantage of their position.	Black Lives Matter
Black lives matter doesn't care about black lives.	Black Lives Matter
Black lives matter is based on a flawed premise.	Black Lives Matter
Black Lives Matter are too violent.	Black Lives Matter
Many paople is being discriminated by the legal system.	Black Lives Matter
All citizens of a society have the same rights, regardless of ethnic groups or races.	Black Lives Matter
Discrimination occurs among people of various race, gender and religion.	Black Lives Matter
This issues comprises issues of racial profiling.	Black Lives Matter
People of color are more likely to be born into poverty.	Black Lives Matter
All people are equal.	Black Lives Matter
Black people have the same rights as whites.	Black Lives Matter
Let everyone live.	Black Lives Matter
Whites have more power and they need to use it to raise other racecs, especially black, up.	Black Lives Matter
Black lives matter is important.	Black Lives Matter
Blacks should be respected.	Black Lives Matter
We must maximize campaigns against racism.	Black Lives Matter
Police racial profiling reduces minorities to negative stereotypes.	Black Lives Matter
White people are also sometimes victims of police brutality.	Black Lives Matter
Peaceful protesting is more productive than violent rallies.	Black Lives Matter
Teaching only evolution does not discriminate religious people.	Creationism in school curricula
Parents should help teachers with chats at home.	Creationism in school curricula
Evolution is accepted science.	Creationism in school curricula
The theory of evolution has many inconcistencies.	Creationism in school curricula
Religion belongs in church and at home, not in the federally-funded school system.	Creationism in school curricula
Religion and education must be kept separate.	Creationism in school curricula
Teaching fact, which can include Bible writings, should be the norm.	Creationism in school curricula
Parents should have a say in what they want their children tought.	Creationism in school curricula
Only teaching evolution is pushing students to think there are no other beliefs.	Creationism in school curricula
Religious symbols do not have a place in public schools.	Creationism in school curricula
Everyone has the right to worship his beliefs.	Creationism in school curricula
Atheists should be banned from schools.	Creationism in school curricula
Teachers should teach creationism and evolution to broaden the students minds.	Creationism in school curricula
Children should be taught truthfullt and freely.	Creationism in school curricula
Religion should be tantamount to science.	Creationism in school curricula
If creationism is taught, then everyone others belief system should be taught.	Creationism in school curricula
Creationism is a first amendement right.	Creationism in school curricula
Teachers should adhere to the curriculum provided by the school district.	Creationism in school curricula
Creationism is not taught in school because it violates separation of church and state.	Creationism in school curricula
Creationism should not be tought in a classroom because it goes against some beliefs.	Creationism in school curricula
The teachers should take a poll on whether to teach creationism.	Creationism in school curricula
Religious symbols should not be allowed in schools.	Creationism in school curricula
Creationism is not backed by science.	Creationism in school curricula
Every body must be free to choose.	Creationism in school curricula
Teaching Creationism is helpful.	Creationism in school curricula
Public education should only focus on evolution.	Creationism in school curricula
Education on religion must come from the home mainly.	Creationism in school curricula
People should be able to choose their own religion.	Creationism in school curricula
Creationism in school curricula should be full enforced.	Creationism in school curricula
Christian religion should be promoted in schools.	Creationism in school curricula
Evolution should be the predominant discipline taught.	Creationism in school curricula
Children are pliable.	Creationism in school curricula
Creationism can be mentioned in school as something some people believe.	Creationism in school curricula
Religious education should stay in the church and home.	Creationism in school curricula
The theory of evolution is a very solid theory that the vast majority of scientists agree upon.	Creationism in school curricula
All the kids should have the option to choose their religion.	Creationism in school curricula
People should be allowed to wear any religious symbols they choose.	Creationism in school curricula
Students also hear the about creation and be presented with evidence for creation.	Creationism in school curricula
Children should learn religion at home, not in school.	Creationism in school curricula
Extremists should be banned from schools.	Creationism in school curricula
Freedom to choose without discrimination must be done.	Creationism in school curricula
Children have the right to choose their own religion in their school.	Creationism in school curricula
Not eveyrone is interested in religion.	Creationism in school curricula
Religion should not be enforced in schools but should be taught.	Creationism in school curricula
Students should have a choice of what they want to be tought.	Creationism in school curricula
Our schools should teach facts, not beliefs.	Creationism in school curricula
People who want their kids to learn creationism can send their kids to a Christian school.	Creationism in school curricula
The children should know about this.	Creationism in school curricula
Public opinion is unimportant to whether creationism belongs in science classes.	Creationism in school curricula
Teachers should be able to say what they think as mentors.	Creationism in school curricula
Teaching creationism's truth is necessary in upholding the truth of the Bible.	Creationism in school curricula
Help open to different opinions.	Creationism in school curricula
Each person should be free to choose what to believe in.	Creationism in school curricula
Freedom of religion is protected by the consitution.	Creationism in school curricula
Teaching creationism as well as evolution gives students freedom to choose.	Creationism in school curricula
Religion should not be imposed.	Creationism in school curricula
There should be freedom of speech among students.	Creationism in school curricula
Freedom of speech does not include the freedom to preach lies as fact.	Creationism in school curricula
We should not ban religion signs in schools.	Creationism in school curricula
Religion has no place in education.	Creationism in school curricula
Teachers should teach all viewpoints on evolution and creationism in school.	Creationism in school curricula
The idea that creationists reject mutation or natural selection is ridiculous.	Creationism in school curricula
An additional educational subject could be included for this topic.	Creationism in school curricula
Freedom of Speech should be allowed for others and a person of common sense and decency will not abuse this right.	Creationism in school curricula
Give students the freedom to choose but do not teach them creationism.	Creationism in school curricula
Proponents of creationism only want their own religion taught in schools, no one else's.	Creationism in school curricula
The school board should decide on a curriculum for all teachers to follow.	Creationism in school curricula
Children should have the freedom to decide if they want to learn about either creationism or evolution or both.	Creationism in school curricula
People in schools should not be made fun of for their religion.	Creationism in school curricula
Scince always must be first.	Creationism in school curricula
We should not combine schools and religion.	Creationism in school curricula
By leaving religion out of the classroom, we respect the plurality of contrary views.	Creationism in school curricula
Freedom of speech should apply to everyone in schools.	Creationism in school curricula
Public schools must adhere to fact.	Creationism in school curricula
We must separate church and state.	Creationism in school curricula
There should not be seperation between state and relegion.	Creationism in school curricula
Children should have the freedom not to be misled.	Creationism in school curricula
Students should be able to learn what they are comfortable learning.	Creationism in school curricula
Parents should teach the creationism in house too.	Creationism in school curricula
Separation of church and state: The words SEPARATION and CHURCH are not in the US Constitution.	Creationism in school curricula
Freedom of expression is vital to our liberties.	Creationism in school curricula
Creationism must be taught in school curriculum.	Creationism in school curricula
Parents should teach teir beliefs to their children.	Creationism in school curricula
Teaching creationism improves social union.	Creationism in school curricula
Schools should accept different points of view.	Creationism in school curricula
Religion should not be in schools.	Creationism in school curricula
Inclusion is always better than seclusion.	Creationism in school curricula
Teachers should not be able to teach students stuff that the students may not believe.	Creationism in school curricula
Children should know these things from a young age.	Creationism in school curricula
Creationism should be taught in school but so should evolution.	Creationism in school curricula
By banning religious symbols you are banning people from expressing their diverse views.	Creationism in school curricula
Childrens should have the option to participate or not in the religious activities on school.	Creationism in school curricula
Teachers should not have freedom to teach whatever they want to teach to children.	Creationism in school curricula
Students should have the freedom to learn creationism if they wish.	Creationism in school curricula
Teachers should not force students to learn evolution.	Creationism in school curricula
The uniqueness that each student brings to the classroom should be celebrated by allowing each student the opportunity to show and tell anything - including their AWANA book, a Bible, the Koran, a hajib, etc.	Creationism in school curricula
Creationism should include just Christian beliefs versus evolution.	Creationism in school curricula
Children should have their own choice to learn what they want.	Creationism in school curricula
All theories should be taught in school.	Creationism in school curricula
Teachers should not have freedom to teach whatever they wish as fact.	Creationism in school curricula
Religon must be taught in school.	Creationism in school curricula
Secularism should be strictly enforced in schools.	Creationism in school curricula
Freedom of speech should apply to teachers as much as anyone else.	Creationism in school curricula
Our school kids deserve the right to hear about creation in school.	Creationism in school curricula
Creationism is a good method that should be applied in all schools.	Creationism in school curricula
God made science.	Creationism in school curricula
Creationism should not be denied by those who do not believe and evolution as science and verifiable fact should be accepted teaching as well.	Creationism in school curricula
Children have the freedom to choose.	Creationism in school curricula
Allowing students the right to learn bothevolution and creationism opens their minds to understanding the views of others.	Creationism in school curricula
Teachers should have a certain curricula to follow what to teach to children.	Creationism in school curricula
Knowing about Creationism is important.	Creationism in school curricula
Teachers who wished to present a balanced approach to this particular hypothesis should be free.	Creationism in school curricula
Education should broaden our horizons. Showing the differences between evolution and creationism allows each student to choose.	Creationism in school curricula
Religion belief should be respected.	Creationism in school curricula
Teachers should not be allowed to teach whatever they wish.	Creationism in school curricula
Teaching evolution exclusively is dangerous to science and reason.	Creationism in school curricula
Everyone should be free of thought.	Creationism in school curricula
Many people believe in creationism.	Creationism in school curricula
Creationism is unscientific.	Creationism in school curricula
Religious schools can teach creationism if that is that is their religion's belief.	Creationism in school curricula
Creationism should be taught at home only.	Creationism in school curricula
People should be able to express their religion through symbols even at schools.	Creationism in school curricula
Religion has no place in a school.	Creationism in school curricula
Schools can imply either a myopic or anti-religious outlook.	Creationism in school curricula
Multiculturalism encourages the teachings of all cultures and beliefs.	Creationism in school curricula
Science must be taught in detail, not creationism which lacks any kind of facts.	Creationism in school curricula
We are a multicultural society. Differences in the way people choose to live should be taught in the classroom.	Creationism in school curricula
Attempts to conceal the creationism-evolution controversy from students are dogmatic promotions of evolution.	Creationism in school curricula
Scientific fact only should be taught in school.	Creationism in school curricula
A good electoral system puts us as a world example	US Electoral System
Free and easy IDs should be able to be obtained so that photo ID can be implemented.	US Electoral System
Photo id's should be presented in cases of new residency	US Electoral System
people should choose their leader	US Electoral System
The counting of votes should be done in presence of all the people	US Electoral System
The people should elect there leader	US Electoral System
Dont let celebrities run for elections.	US Electoral System
All territories are qualified to vote during the election.	US Electoral System
The Electoral college is not for overseas regions	US Electoral System
All state should not use electoral system because its not the people's choice	US Electoral System
Gerrymandering is unfair.	US Electoral System
Swing states seem to dominate votes via the electoral college system	US Electoral System
We must include all US residents.	US Electoral System
Swing states are given too much importance in the electoral college	US Electoral System
The people should have a say over the vote of the electoral	US Electoral System
Gerrymandering should be unethical and penalized	US Electoral System
Electoral system is unfair	US Electoral System
Delegates should be appointed in a clear and well defined fashion.	US Electoral System
The issue includes whether all US overseas regions should be allowed to vote.	US Electoral System
Electoral system is unfair.	US Electoral System
The electoral college should be eliminated.	US Electoral System
Thumb printing system should be used for votes.	US Electoral System
The US electoral system is the set of rules that determines how elections (the election of the President) are conducted	US Electoral System
Photo id's should be presented at the ballot in cases of new residency.	US Electoral System
The Electoral System does not properly match representation of constituents.	US Electoral System
US overseas regions have the right to vote at presidential elections.	US Electoral System
The electoral college needs to be reevaluated.	US Electoral System
Election should be base on interest.	US Electoral System
Changing electoral districts to better reflect societal distributions will benefit the electoral system.	US Electoral System
Elections should be based on popular votes.	US Electoral System
The electoral system needs to be revised.	US Electoral System
Free and easy IDs should be able to be obtained so that  photo ID can be implemented	US Electoral System
No state should be allowed to award electoral votes on an all-or-nothing basis.	US Electoral System
No one outside the us should be allowed to vote for our president.	US Electoral System
It maintains balance in  popular sovereignty	US Electoral System
Electoral college directs more power to the states.	US Electoral System
Everybody should have tolhe right to vote.	US Electoral System
We should require a photo ID for every vote.	US Electoral System
The pepple should select the president not the electoral college.	US Electoral System
Electoral system has a loophole that is being abused.	US Electoral System
Candidates should not be selected by government	US Electoral System
It is difficult to send the vote information of the overseas	US Electoral System
The election should not be based on state votes.	US Electoral System
Popular vote should never be used as a determining factor because it give total control of the country to large coastal states	US Electoral System
The person a majority of Americans favor may not win in the current system.	US Electoral System
Convicted felons who have completed their sentences should be allowed to vote	US Electoral System
All US citizens should be able to vote.	US Electoral System
The outcome of the system should be the peoples will	US Electoral System
Popular votes by the people should be the votes that determine the presidency	US Electoral System
elections should be based on popular votes	US Electoral System
Voter ID should be required to vote.	US Electoral System
Gerrymandering can create an unfair advantage for one party.	US Electoral System
the electoral college should not be as important	US Electoral System
The US voting system is archaic.	US Electoral System
Election right should be open to all.	US Electoral System
Having third parties would get more people to vote.	US Electoral System
The 2016 election was not hacked.	US Electoral System
Requiring a photo id is a valid tool provided the accessibility of obtaining a photo id is not disproportionate based on racial or economic factors.	US Electoral System
The system gives too much importance to the social status	US Electoral System
We should look at other contries to improve our system.	US Electoral System
Small states and swing states get more power through the current system.	US Electoral System
Swing states are no more important than other states in the current system.	US Electoral System
The US Electoral System needs to be changed to more effectively represent individuals.	US Electoral System
These are the ideals set forth in the U.S. Constitution.	US Electoral System
The electoral college system gives too much importance to swing states.	US Electoral System
We should have online voting so physical booths are not manipulated.	US Electoral System
Media plays a role in the US Electoral System, and impacts all elections.	US Electoral System
The voting age should be changed to 16	US Electoral System
All people should have right to vote	US Electoral System
All elections should be based on vote count only.	US Electoral System
the electoral college needs to be reevaluated	US Electoral System
Electoral college maintains balance in popular sovereignty.	US Electoral System
Gerrymandering creates unfair advantge for the party who is setting the electoral districts	US Electoral System
The electoral college is a well tooled method of equalizing population swing in the united states with regard to voting impact.	US Electoral System
Small states and swing states get more power.	US Electoral System
It is difficult to transfer the vote information of the overseas.	US Electoral System
There should be more than two parties.	US Electoral System
All elections should be based on popular vote.	US Electoral System
Gerrymandering is unfair	US Electoral System
Gerrymandering should be unethical and penalized.	US Electoral System
All states should adopt the popular vote.	US Electoral System
The elections are the most important thing in American decisions	US Electoral System
Gerrymandering is a valid system.	US Electoral System
The electoral system makes voting unfair.	US Electoral System
The Electoral System is too complicated and dissuades people from voting.	US Electoral System
All people should have right to vote.	US Electoral System
Compulsory voting should be implemented	US Electoral System
States should do what they can to avoid voter fraud	US Electoral System
All elections should be based on one vote only.	US Electoral System
The elections are rigged.	US Electoral System
There should be a more secure identification system when voting	US Electoral System
Requiring photo ids to vote will place a burden on seniors, the poor, immigrants and lower socio economic groups.	US Electoral System
The electoral system should be more transparent.	US Electoral System
All US citizens should have a right to vote no matter their location	US Electoral System
The US voting system is archaic	US Electoral System
Election should be by ballot casting	US Electoral System
All us citizens should be eligible to vote without discrimination.	US Electoral System
All elections should be based on popular vote	US Electoral System
The electoral system are the ideals set forth in the U.S. Constitution.	US Electoral System
These electors typically vote for the candidate for which their state popularly voted.	US Electoral System
Gerrymandering is immoral and unethical although politically useful.	US Electoral System
More than two parties would make the system more fair.	US Electoral System
Photo id's should be presented to new citizens eligible to vote and those who have moved to different voting districts.	US Electoral System
Popular votes are by the people and should be the determinance of a president by the people for the people	US Electoral System
States should do what they can to avoid voter fraud.	US Electoral System
Our good electoral system puts US as a world example.	US Electoral System
Swing states are given too much importance in the electoral college.	US Electoral System
Swing states seem to dominate votes via the electoral college system.	US Electoral System
Swing states are no more important than other states	US Electoral System
delegates should be appointed in a clear and well defined fashion	US Electoral System
The electoral college protects minority interests.	US Electoral System
Both parties should be involved in determining electoral districts	US Electoral System
Electoral college facilitates a two-party system.	US Electoral System
the electoral college should not be more important than the majority vote	US Electoral System
The system should consist of more than two parties.	US Electoral System
The elections are the most important thing in American decisions.	US Electoral System
Electoral college protects minority.	US Electoral System
Require a photo ID for every vote	US Electoral System
All states should hold primaries on the same day.	US Electoral System
Swing states are too powerful.	US Electoral System
Politicians have control over the electoral system, and have ways to tilt it in their favor.	US Electoral System
No state should be allowed to award electoral votes on an all or nothing basis	US Electoral System
There must be a thorough review of the votes.	US Electoral System
It is always opportune for a better national operation.	US Electoral System
Popular votes by the people should be the votes that determine the presidency.	US Electoral System
Photo Id's can prevent voter fraud.	US Electoral System
The electorial system is in place to make sure that high population areas do not make all the political decisions.	US Electoral System
The electoral system should be done different.	US Electoral System
Both parties should be involved in determining electoral districts.	US Electoral System
The system is archaic and needs to be updated.	US Electoral System
Elections should be obased on popular vote	US Electoral System
The Electoral College is outdated.	US Electoral System
Voters should be required to be registered and with ID to vote on election day.	US Electoral System
US overseas regions should be allowed to vote.	US Electoral System
The electors should do their job by voting for the candidate that got the popular vote.	US Electoral System
US should start abolishing electoral voting system.	US Electoral System
All state should not use electoral system because its not the people's choice.	US Electoral System
We should have more than two big parties.	US Electoral System
Popular votes are by the people and should be the determinance of a president by the people for the people.	US Electoral System
All US citizens should have a right to vote no matter their location.	US Electoral System
The Electoral college does not cover overseas regions.	US Electoral System
Only U.S. citizens living in the 50 states should be allowed to vote.	US Electoral System
Popular vote is more accurathe than Electoral College.	US Electoral System
We should require a id to vote.	US Electoral System
Electoral College vote system is not the best system.	US Electoral System
Compulsory voting should be implemented.	US Electoral System
People should have to have an id in order to vote.	US Electoral System
Election should be by ballot casting.	US Electoral System
The election should be based on a national popular vote.	US Electoral System
The electoral college is limited due to a lack of diverse parties.	US Electoral System
The popular vote would not be a better way to decide elections.	US Electoral System
Smaller states should have as much power as large states.	US Electoral System
requiring photo ids to vote will place a burden on seniors, the poor, immigrants and lower socio economic groups	US Electoral System
We can be proud how the voting results are determined in the USA.	US Electoral System
Employers should be required to close on election days so that their employees have enough time to vote.	US Electoral System
Electoral college is too complicated and dissuades people from voting.	US Electoral System
The counting of votes should be done in presence of all the people.	US Electoral System
Voting for an independent candidate only ensures that the Republican will win.	US Electoral System
The electoral system should have more thought put into it.	US Electoral System
The people should elect there leader.	US Electoral System
Requiring an ID to vote will make voting more difficult for people below the poverty line.	US Electoral System
We should require a id for every vote	US Electoral System
Candidates should not be selected by government.	US Electoral System
There needs to be a buffer between population and the selection of a President.	US Electoral System
The two parties are corrupt.	US Electoral System
The electors in the electoral college do not always vote for the candidate for which their state popularly voted.	US Electoral System
The electoral college should not be given too much priority	US Electoral System
Media plays a too big role in the US Electoral System and all elections.	US Electoral System
The electoral college should not be more important than the majority vote.	US Electoral System
The electoral system has to much power.	US Electoral System
Gerrymandering should not be allowed.	US Electoral System
Popular vote should never be used as a determining factor because it give total control of the country to large coastal states.	US Electoral System
Convicted felons who have completed their sentences should be allowed to vote.	US Electoral System
The electoral system must be fair.	US Electoral System
The electoral college should not be as important at it is.	US Electoral System
The popular vote should beat the electoral vote.	US Electoral System
Electoral college should be monitored for corruption.	US Electoral System
The US electoral system is the set of rules that determines how elections (the election of the President) are conducted.	US Electoral System
The electoral college should not be given too much priority.	US Electoral System
All us citizens should be considered fairly.	US Electoral System
Foreign people should not be allowed to vote	US Electoral System
Polls should not be announced during the election, because they can influence voting behavior.	US Electoral System
Electoral college  directs more power to the states.	US Electoral System
The system gives too much importance to the social status of representatives.	US Electoral System
Gerrymandering creates unfair advantge for the party that creates the district.	US Electoral System
The voting age should be changed to 16.	US Electoral System
Gerrymandering creates unfair advantge for the party who is setting the electoral districts.	US Electoral System
Technology allows us to take place more in a democracy.	US Electoral System
The people should have a say over the vote of the electoral college.	US Electoral System
The us citizens should have a database of all overseas citizens.	US Electoral System
There should be a more secure identification system when voting.	US Electoral System
Electoral college directs more power to smaller states.	US Electoral System
The electoral college is corrupt.	US Electoral System
You have to digitize and monitor live the votes.	US Electoral System
Money should not determine the political candidate.	US Electoral System
Foreign people should be allowed to vote if they are in the US for over a year.	US Electoral System
All regions that are part of the United States and are participants of the government should be allowed to vote.	US Electoral System
Popular vote should matter more in the US electoral system.	US Electoral System
Those who use negative tactics to win in the US Elector System should be ashamed of themselves.	US Electoral System
States should be in control of determining the allowance of immigrants into their domain and the care that may be necessary.	US Immigration
People immigrating from other countries should be loyal to america if they are living here.	US Immigration
We need to limit the amount of refugees allowed.	US Immigration
Immigration has always been a part of america.	US Immigration
European countries are experiencing problems with refugee immigrants.	US Immigration
Immigration does not change national identity of a country built on immigrants.	US Immigration
A person in need should not be denied help and life regardless of where they are from.	US Immigration
Immigration should be controlled to prevent overcrowding in the USA.	US Immigration
Our national and economic security depend on requiring people who are living and working here illegally to come forward and get right with the law.	US Immigration
Immigrants should be able to come to the USA for better opportunities.	US Immigration
Immigrants must pass certain background checks including crime record.	US Immigration
Immigrant will stimulate the economy and enhance America's wealth.	US Immigration
The USA immigration is best best way to repair the economy.	US Immigration
Immigration needs to be done legally only.	US Immigration
Immigrants who commit a serious crime should be permanently expelled.	US Immigration
Immigrants provide a valuable diversity.	US Immigration
Immigrants should be treated better at the borders.	US Immigration
Multiculturalism is desirable.	US Immigration
Immigrants take work no one else wants.	US Immigration
Immigrants bring positive things to the country.	US Immigration
Immigrants have a right to be protected.	US Immigration
Immigration provides cultural growth.	US Immigration
We should take hard measures to enforce immigration laws.	US Immigration
Bans against immigration are really just fronts for prejudice.	US Immigration
Some immigrants possess important skills that our country needs.	US Immigration
Legal immigration provides increased diversity.	US Immigration
The United States is already fully populated, so immigration should be restricted.	US Immigration
Immigrants are good for US economy.	US Immigration
Allowing immigrants into the country makes for a more skilled labor force.	US Immigration
Inmigration have a positive impact on diplomatic relationships.	US Immigration
Immigrants are good for US.	US Immigration
We should stop foreigners taking advantage of us.	US Immigration
US comprise of immigrant eversince.	US Immigration
Elevate refugee immigration to the US; they deserve a safe haven.	US Immigration
Diversity is something that a lot of companies value.	US Immigration
Immigration should be elevated because it brings the best brains to the economity.	US Immigration
Visas should only be issued to students and workers.	US Immigration
Immigrants have a positive impact in the economy.	US Immigration
Migrants have a positive impact on the economy.	US Immigration
Immigration changes national identity in a bad way.	US Immigration
US should hire skilled immigrants.	US Immigration
The US has the right to exclude of certain groups from entering.	US Immigration
Immigrants are needed to make up for aging populations.	US Immigration
Deporting these illegal immigrants can cost the government afortune so it is better to let them stay.	US Immigration
States should focus on their own people first.	US Immigration
Legal status would boost the economy.	US Immigration
The US must be responsible to their own citizens first.	US Immigration
All immigrants should learn American English.	US Immigration
The country must monitor the borders.	US Immigration
Immigrants should be treated like citizens of the country.	US Immigration
Work visas to skilled professionals should be temporary in nature.	US Immigration
Refugees should be helped.	US Immigration
Legal immigration levels should remain the same.	US Immigration
All illegal immigrants should be deported back to their home country.	US Immigration
We are all migrants.	US Immigration
Immigration into the USA should be elevated.	US Immigration
Undocumented aliens are willing to take all kinds of jobs.	US Immigration
America should focus on its own citizens before other countries citizens.	US Immigration
Immigrants are what makes this country what it is.	US Immigration
Illegal immigration is born from the difficulty of emigrating.	US Immigration
The government must set and enforce stricter rules about immigration.	US Immigration
Immigrants are bad for the US.	US Immigration
Background checks must be performed on immigrants.	US Immigration
The U.S. is a melting pot of cultures.	US Immigration
Only children who have one parent who is a US citizen should be granted citizenship.	US Immigration
Not everyone must be elegible for Immigration.	US Immigration
Immigration increases terrorist activity.	US Immigration
Legal immigrants contribute to society.	US Immigration
Immigrants are more often criminals.	US Immigration
Inmigration have a positive impact in the rise of economy.	US Immigration
Illegal immigration should not be allowed and be enforced.	US Immigration
Immigrants are willing to do work that most Americans don't want to do, at a lower cost to the employer.	US Immigration
America should invite all people that need help.	US Immigration
Immigrants contribute to the work force when they come to the country the right way.	US Immigration
Increased diversity results in a better America.	US Immigration
Our country was founded o the principle of encouraging immigration.	US Immigration
Paths to legal immigration should be simplified.	US Immigration
States must be responsible to their own citizens first.	US Immigration
Migrant workers contribute to our economy via business ventures and as employees.	US Immigration
Skilled migration workers are needed.	US Immigration
We must secure our borders.	US Immigration
Congress should immediately fund Trump's wall.	US Immigration
Immigration built the US.	US Immigration
Muslim immigrants can be dangerous.	US Immigration
There are immigrants who make great collaborations with the country.	US Immigration
Immigration takes opportunities away from those born in the usa.	US Immigration
Low cost workers come from Inmigration.	US Immigration
A time limit must be approved for immigrants.	US Immigration
Immigrant will strengthen our national security.	US Immigration
Immigrants have a postivie impact on the economy.	US Immigration
As long as immigrants get to remain in the United States legally, they will have jumped ahead of those in their home countries who are attempting legal entry.	US Immigration
The immigration program needs to be reformed.	US Immigration
Some immigrants come seeking better education and they should not be deprived.	US Immigration
Immigrants create multiculturalism.	US Immigration
Allowing people to becoming legal citizens should be first step in revising the immigration system.	US Immigration
All inmigrants should have the right to vote in the American elections.	US Immigration
The government has to destinate some fund to help immigrants.	US Immigration
Immigrants should come into the US legally only.	US Immigration
At times they help in the progress of the country.	US Immigration
High skilled migrants take jobs from US workers.	US Immigration
Legal immigration should be promoted.	US Immigration
US immigration helps the economy.	US Immigration
People from other countries should fix the problems in their own country, rather than move to another country.	US Immigration
When a person immigrates to a new country they can assume new nationality with their new country.	US Immigration
Undocumented aliens contribute to a richer culture and biodiversity.	US Immigration
We need an immigration reform that focuses on enforcement and upholding the rule of law.	US Immigration
All immigrants should have a detailed background check.	US Immigration
Immigration shouldn't be more important than security.	US Immigration
There should be a way that illegal immigrants can become legalized.	US Immigration
A decrease in population due to aging and death can be regained from an immigrant population including refugees.	US Immigration
Immigration must be regularized.	US Immigration
Immigrants helps boost US economy.	US Immigration
Immigration should be legal and orderly.	US Immigration
Immigrants visas should be constantly evaluated and revised.	US Immigration
Illegal immigrants take jobs away from Americans.	US Immigration
Most immigrants pay taxes.	US Immigration
Legal immigration has brought some great scientists to the United States.	US Immigration
All immigrants should be legal.	US Immigration
Illegal immigration should be banned.	US Immigration
Come to the US through legal channels or don't come at all.	US Immigration
Legal immigration is important for low paying jobs that Americans do not want.	US Immigration
We are all the descendants of immigrants.	US Immigration
Immigration should be limited.	US Immigration
Immigrants are known for working cheaper.	US Immigration
It's in the public interest to acknowledge that refugees cause harm.	US Immigration
Inclusion should be facilitated for immigrants.	US Immigration
Immigration is what made us what it is today.	US Immigration
States must be responsible for everyone present, not just citizens.	US Immigration
Immigration makes US more attractive to tourists.	US Immigration
Immigrants are better workers tha US workers.	US Immigration
Vegetarianism is healthier than other diet plans.	Vegetarian & Vegan Lifestyle
Veganism is not healthy.	Vegetarian & Vegan Lifestyle
People should be free to eat whatever they want.	Vegetarian & Vegan Lifestyle
There are better ways than being vegetarian and vegan to have a healthy lifestyle.	Vegetarian & Vegan Lifestyle
We have the right to choose what to eat.	Vegetarian & Vegan Lifestyle
Meat production pollutes our environment.	Vegetarian & Vegan Lifestyle
Meat provides the nutrients required for good health.	Vegetarian & Vegan Lifestyle
People can choose a nutrition plan that is suitable for them.	Vegetarian & Vegan Lifestyle
Humans are made to eat meat.	Vegetarian & Vegan Lifestyle
Vegan lifestyle cuts out dairy completley.	Vegetarian & Vegan Lifestyle
Many celebrities are vegan.	Vegetarian & Vegan Lifestyle
Vegetarianism is healthier than veganism.	Vegetarian & Vegan Lifestyle
Tofu is not a healthy substitute for animal protein.	Vegetarian & Vegan Lifestyle
Creating a nutrition plan is left for the person.	Vegetarian & Vegan Lifestyle
There are too many people who take Vegetarian & Vegan Lifestyle to the extreme.	Vegetarian & Vegan Lifestyle
Not eating animals can lead to having more pets.	Vegetarian & Vegan Lifestyle
A vegetarian diet is healthy and beneficial over a meat based diet.	Vegetarian & Vegan Lifestyle
Freedom to chose your nutrition.	Vegetarian & Vegan Lifestyle
Eating meat has been an essential part of human evolution.	Vegetarian & Vegan Lifestyle
Vegan is a good cancer prevention.	Vegetarian & Vegan Lifestyle
Meat consumption contributes to air and water pollution.	Vegetarian & Vegan Lifestyle
It is immoral to eat vegetable only.	Vegetarian & Vegan Lifestyle
Meat consumption should be limited.	Vegetarian & Vegan Lifestyle
Vegan lifestyles are good for the environment.	Vegetarian & Vegan Lifestyle
Humans are meant to be vegan.	Vegetarian & Vegan Lifestyle
A vegan or vegetarian diet lacks nutrition only found in meat.	Vegetarian & Vegan Lifestyle
Real leather makes a statement about the woman who carries it (purse).	Vegetarian & Vegan Lifestyle
Vegans are at reduced risk of serious illness.	Vegetarian & Vegan Lifestyle
Eating plants reduce animal extinction.	Vegetarian & Vegan Lifestyle
Avoid discriminating against non-vegetarians and vice versa.	Vegetarian & Vegan Lifestyle
Killing animals is harmful.	Vegetarian & Vegan Lifestyle
It's immoral to kill animals.	Vegetarian & Vegan Lifestyle
Vitamins and pills are not safe substitutes for meat.	Vegetarian & Vegan Lifestyle
There are just as many animals killed in the dairy and egg industries as the meat industry.	Vegetarian & Vegan Lifestyle
There are many vegan options for protein.	Vegetarian & Vegan Lifestyle
Meat is needed to grow.	Vegetarian & Vegan Lifestyle
Carnivorous diets are unhealthy.	Vegetarian & Vegan Lifestyle
It is possible to kill animals in a manner that is humane.	Vegetarian & Vegan Lifestyle
Being a vegetarian is healthier for you.	Vegetarian & Vegan Lifestyle
Humans do not need meat to survive.	Vegetarian & Vegan Lifestyle
Eating animals reduces deforestation.	Vegetarian & Vegan Lifestyle
Is immoral to kill animals.	Vegetarian & Vegan Lifestyle
Animals used in meat production are mistreated.	Vegetarian & Vegan Lifestyle
People should be free to choose their own nutrition plan.	Vegetarian & Vegan Lifestyle
Beef can cause heart attack.	Vegetarian & Vegan Lifestyle
Vegetarianism is becoming more popular.	Vegetarian & Vegan Lifestyle
Meat is a good source of nutrients.	Vegetarian & Vegan Lifestyle
Most vegans and vegetarians are healthier then those who eat meat.	Vegetarian & Vegan Lifestyle
These are other lifestyles and life choices that do have more benefits including the ability to grow a lot of one's own food safely and organically.	Vegetarian & Vegan Lifestyle
Vegetarism and veganism has interferences with existing medical conditions.	Vegetarian & Vegan Lifestyle
Meat is bad for humans.	Vegetarian & Vegan Lifestyle
Some animals are here on earth to eat them.	Vegetarian & Vegan Lifestyle
Eating animals is part of the natural life cycle.	Vegetarian & Vegan Lifestyle
People have the right to choose he kind of meal they want to eat.	Vegetarian & Vegan Lifestyle
Human beings are biological omnivores.	Vegetarian & Vegan Lifestyle
Farming also contributes to air and water pollution.	Vegetarian & Vegan Lifestyle
The vegan diet has many health benefits.	Vegetarian & Vegan Lifestyle
Eating meat is essential to human development.	Vegetarian & Vegan Lifestyle
Meat production is bad for the environment.	Vegetarian & Vegan Lifestyle
Being a vegan saves animals lives.	Vegetarian & Vegan Lifestyle
Being vegetarian is healthy lifestyle.	Vegetarian & Vegan Lifestyle
Eating plant can relieve animal extinction.	Vegetarian & Vegan Lifestyle
Veganism is like a religion.	Vegetarian & Vegan Lifestyle
There are other sources of B-12 than meat.	Vegetarian & Vegan Lifestyle
There is more protein in plants than animals.	Vegetarian & Vegan Lifestyle
Lack of essential vitamins and minerals.	Vegetarian & Vegan Lifestyle
Meat can cause diseases.	Vegetarian & Vegan Lifestyle
Animal protection should be maximized.	Vegetarian & Vegan Lifestyle
Vegan lifestyle is the healthiest.	Vegetarian & Vegan Lifestyle
It is good that more people are starting to go Vegan.	Vegetarian & Vegan Lifestyle
Using cows for dairy production is cruel.	Vegetarian & Vegan Lifestyle
Killing animals is against Gods law.	Vegetarian & Vegan Lifestyle
Having more vegetarian options in stores helps boost the economy by creating another group of consumers.	Vegetarian & Vegan Lifestyle
Vegan lifestyle results in a short of essential vitamins and minerals.	Vegetarian & Vegan Lifestyle
Vegan lifestyle should be adopted.	Vegetarian & Vegan Lifestyle
Eating animal can reduce deforestation.	Vegetarian & Vegan Lifestyle
Killing animals is a sin.	Vegetarian & Vegan Lifestyle
People should just eat vegetables.	Vegetarian & Vegan Lifestyle
Vegan is the healthier lifestyle.	Vegetarian & Vegan Lifestyle
Eating meat is also good for humans body.	Vegetarian & Vegan Lifestyle
Vegetarianism will result in more animals than the earth can support.	Vegetarian & Vegan Lifestyle
Most slaughter houses are over crowded and do not properly care for animals.	Vegetarian & Vegan Lifestyle
We should consume meat more conscious.	Vegetarian & Vegan Lifestyle
Vegans are healthier than omnivores.	Vegetarian & Vegan Lifestyle
Vegetarians, such as 7th Day Adventists, are healthy people.	Vegetarian & Vegan Lifestyle
Enough protein can be found in vegetarian sources.	Vegetarian & Vegan Lifestyle
Meat offers important nutrients.	Vegetarian & Vegan Lifestyle
Meat is as healthy as vegetables.	Vegetarian & Vegan Lifestyle
Vegetarian lifestyles reduce risk of the No. 1 killer – Heart Disease.	Vegetarian & Vegan Lifestyle
People living the vegan are much healthier lifestyle.	Vegetarian & Vegan Lifestyle
A health plan leads to a healthy life.	Vegetarian & Vegan Lifestyle
The consumption or not of meat must be right of each person.	Vegetarian & Vegan Lifestyle
A vegan diet promotes weight loss.	Vegetarian & Vegan Lifestyle
God said that is ok to kill animals for human's consumtion.	Vegetarian & Vegan Lifestyle
Animals only must die for eating.	Vegetarian & Vegan Lifestyle
A persons food choice should be there own right to decide.	Vegetarian & Vegan Lifestyle
Eaiting meat is not healthy.	Vegetarian & Vegan Lifestyle
People should be able to make their own choices on what they eat.	Vegetarian & Vegan Lifestyle
I like cows, so I don't eat them.	Vegetarian & Vegan Lifestyle
Vegetarianism is healthier.	Vegetarian & Vegan Lifestyle
Animals have feelings and it is cruel to eat them.	Vegetarian & Vegan Lifestyle
Vegetarians face unrealistic expectations.	Vegetarian & Vegan Lifestyle
Humans have evolved to eat meat.	Vegetarian & Vegan Lifestyle
Being vegan is healthy.	Vegetarian & Vegan Lifestyle
Being a vegetarian is a good way to care for animals.	Vegetarian & Vegan Lifestyle
The decision of a person to be or not to be vegetarian must be respected.	Vegetarian & Vegan Lifestyle
There are certain nutrients, such as Zinc, Iron, and Protein, that are most efficiently consumed by eating meat.	Vegetarian & Vegan Lifestyle
If people want to eat meat then let them.	Vegetarian & Vegan Lifestyle
A persons diet should be there choice and the individual freedoms of choosing one food should not be shamed.	Vegetarian & Vegan Lifestyle
Vegetarian should be encouraged.	Vegetarian & Vegan Lifestyle
All people should be free to choose between vegan or vegetarian lifestyle.	Vegetarian & Vegan Lifestyle
It is immoral to kill animals.	Vegetarian & Vegan Lifestyle
Killing animals for food is part of being a person.	Vegetarian & Vegan Lifestyle
People should eat less meat.	Vegetarian & Vegan Lifestyle
If people want to be vegan - let them.	Vegetarian & Vegan Lifestyle
Human teeth have developed to eat meat.	Vegetarian & Vegan Lifestyle
There should be more vegetarian options available to increase diversity.	Vegetarian & Vegan Lifestyle
Eating meat leads to cardiovascular disease.	Vegetarian & Vegan Lifestyle
Humans have been natural carnivores for ages as is displayed through evolution such as that humans have canine teeth and the capability of eating and properly consuming meat.	Vegetarian & Vegan Lifestyle
Living a vegan lifestyle makes you look good.	Vegetarian & Vegan Lifestyle
Milk and Chees are good for people.	Vegetarian & Vegan Lifestyle
A vegan lifestyle is healthier.	Vegetarian & Vegan Lifestyle
Vegetarian and vegan lifestyles help to regulate blood pressure.	Vegetarian & Vegan Lifestyle
Cows milk should be for calves only.	Vegetarian & Vegan Lifestyle
Vegetarians are healthier.	Vegetarian & Vegan Lifestyle
It would not be practical to meet the world's food needs with a purely plant-based diet.	Vegetarian & Vegan Lifestyle
Vegans should not put down non vegans or vice versa.	Vegetarian & Vegan Lifestyle
No studies prove that a vegetarian lifestyle is healthier.	Vegetarian & Vegan Lifestyle
We spend too much on foreign aid.	Foreign Aid
Foreign aid should be time limited to prevent dependence.	Foreign Aid
Our taxes are being used to Foreign aid.	Foreign Aid
US should make their spending transparent so as to avoid abuse of power.	Foreign Aid
The US should use funding to better the lives of US citizens.	Foreign Aid
Foreign aid should be emphasised.	Foreign Aid
The US shouldn't be borrowing money at all.	Foreign Aid
The foreign aid budget should be made transparent.	Foreign Aid
Usa should help itself first.	Foreign Aid
Foreign aid should be a collective system.	Foreign Aid
The US should play a major role in foreign aid.	Foreign Aid
We need to focus on ourselves before others.	Foreign Aid
One must measure to what extent united states can help another country.	Foreign Aid
Foreign aid could improve the diplomatic relationships.	Foreign Aid
Foreign aid help other nations fight drugs and other problems like HIV/AIDS.	Foreign Aid
Foreign aid should not be provided to countries who support terrorism.	Foreign Aid
Foreign Aid must be limited to very poor countries.	Foreign Aid
Foreign aid should be limited to develop basic infrastructure.	Foreign Aid
US should give foreign aid if US can get something in return.	Foreign Aid
The budget for foreign aid should be more effective.	Foreign Aid
Foreign aid is a voluntary transfer of resources from one country to another.	Foreign Aid
Foreign aid can help with social issues.	Foreign Aid
The U.S. should stay focused on solving its own problems.	Foreign Aid
Helping the poor to survive.	Foreign Aid
We need a more efficient budget for foreign aid.	Foreign Aid
Helping is always a good example.	Foreign Aid
The need to borrow fund to allow others to borrow funds is ridiculous.	Foreign Aid
Foreign aid from the us should be used to help better the lives of less fortunate people.	Foreign Aid
It is best to make grow instead of Aid.	Foreign Aid
Can help great strides in the future.	Foreign Aid
This issue is about whether the US should be sending foreign aid and how this aid should look like.	Foreign Aid
More foreign aid should be sent to countries in need.	Foreign Aid
Foreign Aid is humanitarian act by the US.	Foreign Aid
Foreign aid helps improve education in third world countries.	Foreign Aid
The US should limit foreign aid in order to help domestic agendas.	Foreign Aid
There are many countries that require foreign aid.	Foreign Aid
Foreign aid promotes better relationships among countries.	Foreign Aid
We should not be borrowing to fund foreign aid.	Foreign Aid
US should focus on their own spending habits.	Foreign Aid
The U.S. should only help countries that have helped the U.S. at one time or another.	Foreign Aid
Foreign aid should be a source of help.	Foreign Aid
Foreign aids can save lives.	Foreign Aid
Extending foreign aid will help other countries be more independent.	Foreign Aid
It is the U.S.'s duty to support other countries.	Foreign Aid
Foreign economies flourish thanks to foreign aid.	Foreign Aid
Foreign aid is useful in general.	Foreign Aid
Foreign aid should not provide funds for military actions.	Foreign Aid
Foreign trade should be encouraged.	Foreign Aid
Foreign aids uplift corruption.	Foreign Aid
Foreign aid should be encouraged.	Foreign Aid
The country already has too much debt to afford helping other countries.	Foreign Aid
The foreign aid budget should be made more effective and transparent.	Foreign Aid
Foreign aid is necessary in order to maintain a good rapport with other countries.	Foreign Aid
We should rethink how foreign aid is administered.	Foreign Aid
Methods need to be in place to ensure foreign aid is being sent to what it was intended for.	Foreign Aid
Foreign aid should be limited to countries who will accept humanitarian relief without strings attached.	Foreign Aid
Trade can be a great benefactor in help and future trade.	Foreign Aid
The focus should be on aid, not trade.	Foreign Aid
We should focus on Foreign Aid rather than defense.	Foreign Aid
The foreign aid can help ease poverty in poor countries.	Foreign Aid
The focus should be on improving trade unions with other countries.	Foreign Aid
The government should destinate some funds to foreign aid.	Foreign Aid
Foreign helps promote peace.	Foreign Aid
The focus of aid should be on securing the lives of other citizens from other countries.	Foreign Aid
The Us is losing money because of the Aid.	Foreign Aid
Foreign aid is to promote peace and good relations.	Foreign Aid
Foreign aid should be focused on African countries.	Foreign Aid
The U.S. should take care of its own first.	Foreign Aid
Foreign aid decreases the spread of AIDS in Africa.	Foreign Aid
Stop borrowing money and raise tax payers dollars.	Foreign Aid
US should put a limit to the Foreign Aid.	Foreign Aid
Helping other countries will only increase those nations' dependence on the U.S.	Foreign Aid
Foreign aid helps developing countries stay politically stable.	Foreign Aid
Foreign aid should not be our main focus.	Foreign Aid
We should consider helping more than attacking.	Foreign Aid
The us needs to track better the use of the foreign aid.	Foreign Aid
The us should be helping less fortunate countries.	Foreign Aid
We should clearly know where our funding is going and why.	Foreign Aid
The US should continue to provide foreign aid.	Foreign Aid
US should focus less on the army and focus more on aid.	Foreign Aid
It is better to teach those to defend themselves to provide future security and hope.	Foreign Aid
Foreign aid should be increased, especially following natural disasters around the world.	Foreign Aid
Foreign aid ends up in the hands of despots.	Foreign Aid
Foreign aid is important to improving the quality of life for international citizens.	Foreign Aid
The focus should be on the development of other countries.	Foreign Aid
Foreign aid budget should be more effective.	Foreign Aid
We should increase aid to well established groups like doctors without borders and the peace corps.	Foreign Aid
Our country should not borrow money in order to fund foreign aid.	Foreign Aid
Every developing country needs foreign aid.	Foreign Aid
The US should not provide aid to countries that are against American ideals.	Foreign Aid
Foreign aid is good for business.	Foreign Aid
Foreign aid helps allies to become successful nations.	Foreign Aid
Foreign aid should concentrate on sustainable development.	Foreign Aid
Foreign aid can lead to further difficulties for both countries.	Foreign Aid
We should focus on helping ourselves first before providing aid.	Foreign Aid
Foreign aid is beneficial to involved countries, the donor and recipient.	Foreign Aid
Spending should focus on defence rather than aid.	Foreign Aid
To be independant of other equipping those with the capabilities to defend is a lifelong lesson.	Foreign Aid
Foreign aid should have a portion set aside for countries suffering national disasters.	Foreign Aid
Foreign aids promotes corruption.	Foreign Aid
Foreign aid from the us should be used for shelter for less fortunate people.	Foreign Aid
Starving children are helped with foreign aid donations.	Foreign Aid
The US should think more before they spend aid.	Foreign Aid
Defence assistance can help teach way to fend for one's country for future prosperity.	Foreign Aid
It is our duty to help other humans.	Foreign Aid
We should give all we can to help countries that need it.	Foreign Aid
We should be working to help countries become self sufficient.	Foreign Aid
Foreign aid could improve the status of America.	Foreign Aid
We need to assess foreign aid and how it can be spent more effectivly.	Foreign Aid
Foreign aid promotes better relationships between countries.	Foreign Aid
Foreign aid should be corruption free.	Foreign Aid
Foreign aid should not contribute to our debt.	Foreign Aid
The US should not provide aid to countries that violate human rights.	Foreign Aid
US should stop foreign aid and think America first.	Foreign Aid
Foreign aid from one country should not be borrowed by the giver as this is senseless.	Foreign Aid
Foreign aid helps those who are caught in crises.	Foreign Aid
Foreign aid is necessary to preventing the spread of global pandemics.	Foreign Aid
The lifes of Africa are imparted.	Foreign Aid
Foreign aid helps those in crises.	Foreign Aid
America should help other Countries that need help.	Foreign Aid
Foreign Aid helps form new potential allies.	Foreign Aid
Foreign aid is important.	Foreign Aid
US spending should not be on social welfarism of other countries.	Foreign Aid
The government should help less privileged country.	Foreign Aid
US spending should focus on defence rather than aid.	Foreign Aid
The foreign aid can be expensive for taxpayers.	Foreign Aid
We need to budget more closely on foreign aid.	Foreign Aid
Private charities are more effective than foreign aid.	Foreign Aid
The focus should be on helping other countries.	Foreign Aid
Foreign aid ends up funding terrorism.	Foreign Aid
People have the right to know where there taxes are going and why.	Foreign Aid
We should look more closely into how foreign aid is being spent.	Foreign Aid
Foreign aid should be based on need, not promoting u.s. interests.	Foreign Aid
Transparency in all aspects of foreign aid should be a right bestowed by the people of the country providing aid.	Foreign Aid
The foreign aid budget should be made more effective.	Foreign Aid
African need foreign aids.	Foreign Aid
Other countries should step up and help themselves.	Foreign Aid
Trade and aid should be equal considerations.	Foreign Aid
Foreign leaders should be thankful for our help in giving citizens the ability to have clean drinking water.	Foreign Aid
The us should not be helping other countries.	Foreign Aid
Trade should receive more attention rather than focusing on aid.	Foreign Aid
Foreign Aid is too expensive.	Foreign Aid
We should be spending money on our own country.	Foreign Aid
Foreign aid does more to improve our relationship with the rest of the world than it costs us.	Foreign Aid
America is way better off financially than most countries of the world.	Foreign Aid
The focus should be on trade not on aid.	Foreign Aid
Foreign aid does not go to the people because of corruption.	Foreign Aid
It is needed to aid ourselves before aid foreigner.	Foreign Aid
Foreign aid lead to further difficulties for both countries.	Foreign Aid
There should be more funding of foreign aid.	Foreign Aid
Gender equality is about the acceptance of role models.	Gender Equality
Employers benefit when hiring based an skill and capability, not gender.	Gender Equality
Women should be able to have the same opportunities as men.	Gender Equality
Gender never makes someone look dull instead it makes a person look lively.	Gender Equality
There is no clear link between having gender quotas and economic growth.	Gender Equality
Wages should not be based on gender.	Gender Equality
Men need women.	Gender Equality
Gender equality is a basic human right.	Gender Equality
Gender equality is stupid.	Gender Equality
Women are more powerful than men.	Gender Equality
The training of women in scientific knowledge gives them legitimacy to defend themselves and dismantle negative stereotypes.	Gender Equality
Men can easily be home stay at home dads.	Gender Equality
Women need men.	Gender Equality
If women want to be paid the same as men, then they need to work just as hard.	Gender Equality
Public and private institutions should hire people based on skills not gender to achieve positive economic impact.	Gender Equality
Gender inequality is the main source of sexual harrasment in various countries.	Gender Equality
Women are just as capable as men.	Gender Equality
A woman should have the right to choose her own path.	Gender Equality
Gender equality is part of human rights.	Gender Equality
Gender quotas support economic growth.	Gender Equality
A women should be hired and promoted based on merit alone.	Gender Equality
Women fought hard for rights and should be treated as equals.	Gender Equality
Gender equality is good for the society.	Gender Equality
We should promote the inclusion of women in men's activities.	Gender Equality
Gender equality is the state of equal ease of access to resources and opportunities regardless of gender.	Gender Equality
The society needs woman.	Gender Equality
Sexual harrasment has done more harm to women.	Gender Equality
Recognition in professional contribution must be evaluated by the ability and skill of the individual, not by their gender.	Gender Equality
There are laws that should be better enforced to protect womens rights.	Gender Equality
Decreasing the importance of women in the workforce does not improve work performances.	Gender Equality
All people should be treated equally.	Gender Equality
Companies should promote gender equity.	Gender Equality
Women are usually stereotyped into the housewife role.	Gender Equality
More women are becoming better educated than men.	Gender Equality
Feminists are way too out of proportions.	Gender Equality
The wage gap is a made up thing.	Gender Equality
A family must have a paternal and maternal figure.	Gender Equality
Gender equality provides empowerment for everyone.	Gender Equality
Gender equality has come a long way.	Gender Equality
Women should have the same opportunities as men.	Gender Equality
Women who choose to be stay at home mothers should not be looked down on by society.	Gender Equality
Women should not be in the army (direct combat forces).	Gender Equality
If someone wants to hire a male over a female then let them.	Gender Equality
When a woman is educated she lifts the community and the nation.	Gender Equality
There is no such thing as a glass ceiling anymore.	Gender Equality
Women’s rights have well found legal basis.	Gender Equality
Women should be paid less because they are more expensive employees.	Gender Equality
Gender equality is a desired, possible and realistic goal.	Gender Equality
Women should have the same rights than men.	Gender Equality
Equality is not limited by law.	Gender Equality
Gender does not prevent females to do what the want.	Gender Equality
Gender Equality can generate great advances.	Gender Equality
God created man and woman to be together.	Gender Equality
What's good for a man is also good for a woman.	Gender Equality
The bibles role models are dumb and should be discarded.	Gender Equality
Education empowers women and girls as well as the employment community.	Gender Equality
Hiring should be done on a person's talent and not their gender.	Gender Equality
Gender equiality is a must.	Gender Equality
Gender equality is a global need.	Gender Equality
Same rights same duties.	Gender Equality
Woman should be provided the sam benefits as a man for doing the same job.	Gender Equality
Everybody should have the right to work regardless of gender.	Gender Equality
Gender equality is against religion.	Gender Equality
People shouldn't look at things such as man or woman.	Gender Equality
Everybody should have the right to live regardless of gender.	Gender Equality
We shouldn’t oppose biblical roles of husbands & wives.	Gender Equality
It is a woman's choice to be educated or a mother.	Gender Equality
Sexism in the workplace is a thing of the past.	Gender Equality
Gender Equality exposes women to risks.	Gender Equality
Human rights cannot be achieved until there is gender equality.	Gender Equality
Skills and qualifications should matter more than gender.	Gender Equality
Gender discrimination should be frown at.	Gender Equality
The society has to understand that women are equal to men.	Gender Equality
The condition of woman's mother makes her different from men.	Gender Equality
Women can be bread winners in the household.	Gender Equality
Opportunities should be just as open to women as men.	Gender Equality
Families were stronger when women stayed home and only the men worked.	Gender Equality
A woman is a man's best friend.	Gender Equality
Women should be able to move up in the workplace without discrimination.	Gender Equality
Women are the mothers of the society.	Gender Equality
Feminism is nothing but a male bashing movement.	Gender Equality
Women can be as good workers as men.	Gender Equality
Places don't hire people based on gender.	Gender Equality
Every gender should have specific duties and rights.	Gender Equality
Women should have the same right as men.	Gender Equality
The rights of women are equal to those of men.	Gender Equality
Women should be paid equal to men.	Gender Equality
Sanctions should be applied to gender discriminators.	Gender Equality
Gender inequality must be eliminated.	Gender Equality
Women should be paid the same as men.	Gender Equality
Public and private institutions should hire people based on skills not gender.	Gender Equality
Public and private institutions should hire people based.	Gender Equality
Women are often discriminated against in the workforce and that needs to change.	Gender Equality
Gender equality opens opportunities for the female community.	Gender Equality
Women are more capable than men for many things.	Gender Equality
Everybody should be treated equally regardless of gender.	Gender Equality
You should be judged on who you are not your gender.	Gender Equality
Not having a family in classic role models does not set a good example for the child.	Gender Equality
Men and women have innate differences.	Gender Equality
Women should be given a chance like men.	Gender Equality
Gender inequality affects both genders.	Gender Equality
Everyone is equal.	Gender Equality
Women can be as successful as men.	Gender Equality
Females are just as capable as males.	Gender Equality
No one should judge a person by their gender.	Gender Equality
Women and men have different strengths.	Gender Equality
Gender should be overlooked when choosing criteria comes in.	Gender Equality
Women are as important as men.	Gender Equality
Avoid gender discrimination with campaigns.	Gender Equality
Women are not taken seriously in business.	Gender Equality
If a female wants to work and the guy wants to stay home, who cares.	Gender Equality
There are some jobs that women are better suited for just as there are some jobs men are better suited for.	Gender Equality
Not having good role models make children to fall into crimes.	Gender Equality
Human right can be achieved regardless of gender equality.	Gender Equality
Gender equality is desired by the majority of people.	Gender Equality
Women should be treated as men.	Gender Equality
Women should have the same rights as men.	Gender Equality
Women should have more access to affordable childcare.	Gender Equality
Gender equality is not inline with religion.	Gender Equality
Abolition of gender discriminating laws.	Gender Equality
Instead of fighting for gender equality, we must fight for gender equity.	Gender Equality
Gender inequality hinders the rights of people.	Gender Equality
Education empowers a business and further education among women benefits an employer.	Gender Equality
Women can be as hard workers as men.	Gender Equality
Mens should help their wifes at home duties.	Gender Equality
A woman's physical condition makes her unsuitable for certain jobs.	Gender Equality
What a man can do a woman can do better.	Gender Equality
Women and men should be treated the same.	Gender Equality
Females and males are equal.	Gender Equality
Gender equality can cause problems with the Constitution.	Gender Equality
Marriage is for everyone.	Legalization of Same-sex Marriage
Same sex Marriaged should not get especial legal treatment.	Legalization of Same-sex Marriage
It is wrong to discriminate against homosexuals.	Legalization of Same-sex Marriage
Allowing same-sex marriage will lead to an increase in the AIDS epidemic.	Legalization of Same-sex Marriage
Same-sex marriage should be allowed as they are humans who feel emotions as well.	Legalization of Same-sex Marriage
Same sex adopting could solve the issue of overcrowded orphanages.	Legalization of Same-sex Marriage
Not all marriages reproduce, so same sex couples should not be treated differently just because they cannot biologically reproduce with each other.	Legalization of Same-sex Marriage
The Bible is against homosexuality.	Legalization of Same-sex Marriage
Gay people can be just fine parents.	Legalization of Same-sex Marriage
Gay couples make good parents.	Legalization of Same-sex Marriage
Gay people should have the same rights as straight people.	Legalization of Same-sex Marriage
For tax purposes same sex couples should be able to file jointly.	Legalization of Same-sex Marriage
Marriage is a legal contract and should be open to all consenting adults.	Legalization of Same-sex Marriage
Marriage is for procreation and should not be extended to same-sex couples because they cannot produce children together.	Legalization of Same-sex Marriage
Legalizing same-sex marriage promotes and advances the homosexual agenda  with children being targeted.	Legalization of Same-sex Marriage
The bible defines homosexual acts as abominations. End of conversation.	Legalization of Same-sex Marriage
One person's believes should not affect another persons rights.	Legalization of Same-sex Marriage
Religious beliefs should not enter into the right to marry.	Legalization of Same-sex Marriage
Same sex marriage should be allowed.	Legalization of Same-sex Marriage
Gay people should have the right to get married.	Legalization of Same-sex Marriage
Adoption by same sex partners can provide a home to a child in need.	Legalization of Same-sex Marriage
Love is love no matter the gender.	Legalization of Same-sex Marriage
It is unfair not to afford homosexuals the same rights.	Legalization of Same-sex Marriage
Homosexuals should have the same rights as heterosexuals.	Legalization of Same-sex Marriage
Same-sex marriage should not be legalized.	Legalization of Same-sex Marriage
Legalizing same sex marriage protects the partners.	Legalization of Same-sex Marriage
God intended marriage to between a man and woman only.	Legalization of Same-sex Marriage
Legalizing same sex marriage protects the children of these unions.	Legalization of Same-sex Marriage
Gay marriage is a slippery slope to normalizing other fetishes.	Legalization of Same-sex Marriage
Allowing gay marriage is encouraging same sexual relationships that can lead  to AIDs.	Legalization of Same-sex Marriage
Legalization of gay marriage leads down the slippery slope of eliminating gender identity  leading to gender confusion.	Legalization of Same-sex Marriage
Same-sex marriage violated the word of God thus is incompatible with the beliefs of many religions.	Legalization of Same-sex Marriage
Every person should have the right to marry who they choose.	Legalization of Same-sex Marriage
There should be the same conditions for gay and heterosexual couples.	Legalization of Same-sex Marriage
Gay couples are a good example for all the people.	Legalization of Same-sex Marriage
In the instance that it is believed marriage is for reproduction purposes same sex marriages do not fit this standard.	Legalization of Same-sex Marriage
Same sex marriage increases the chances of leading to other unaccepted marriages (e.g. with animals) and non traditional marriages.	Legalization of Same-sex Marriage
There is no evidence that same-sex couples are any more likely to get divorced than opposite-sex couples.	Legalization of Same-sex Marriage
Same-sex marriages increase the chances of leading to other unaccepted love-forms such as incest, polygamy and bestiality.	Legalization of Same-sex Marriage
Marriage should not be a political argument.	Legalization of Same-sex Marriage
Everybody have freedom of their choice and therefore should be entitled for same sex marriage.	Legalization of Same-sex Marriage
We all must have the same rights.	Legalization of Same-sex Marriage
Gay couples should have the same rights as other couples.	Legalization of Same-sex Marriage
Banning same-sex marriage is a violation of the separation of church and state.	Legalization of Same-sex Marriage
Marriage is an international recognized human right for all people.	Legalization of Same-sex Marriage
Same sex violate the word of God hence is incompatible with the belief of many religions.	Legalization of Same-sex Marriage
Marriage equality provides legitimacy to already existing relationships.	Legalization of Same-sex Marriage
Same-sex couples are just as capable  of forming a family unit.	Legalization of Same-sex Marriage
Same-sex marriage allows same sex couples to share health insurance benefits like any other married couple.	Legalization of Same-sex Marriage
Allowing same-sex marriage will create a "slippery slope" where people will begin to fight for other alternative marriages  such as polygamy.	Legalization of Same-sex Marriage
Same-sex marriage will speed up the assimilation of gay individuals into the mainstream heterosexual culture which will be detrimental to the homosexual community.	Legalization of Same-sex Marriage
Same sex marriage is not moral.	Legalization of Same-sex Marriage
Human rights encompass all equally.	Legalization of Same-sex Marriage
Marriage was God's idea. He defined it as between a man and a woman only. End of conversation.	Legalization of Same-sex Marriage
If same sex couples were to adopt it would confuse the child.	Legalization of Same-sex Marriage
Gay Marriage should be legalized.	Legalization of Same-sex Marriage
Denying marriage to only certain groups is discrimination.	Legalization of Same-sex Marriage
Parenting capabilities should not be determined by whether a person is gay or not as parents from opposite sex marriages are also capable of bad parenting.	Legalization of Same-sex Marriage
Same sex couples should have access to the same benefits and securities as couples of opposite sex.	Legalization of Same-sex Marriage
Gay couple are responsible like a heterosexual couple.	Legalization of Same-sex Marriage
It is immoral to deny same sex couples the right to marry.	Legalization of Same-sex Marriage
Legalization of Same-sex Marriage is not Natural.	Legalization of Same-sex Marriage
People should have the same benefits in regards to marriage no matter what.	Legalization of Same-sex Marriage
Same-sex couples should have access to the same benefits enjoyed by heterosexual married couples.	Legalization of Same-sex Marriage
Homosexuals can be as good a person as a heterosexual.	Legalization of Same-sex Marriage
The Supreme Court overstepped its bounds by allowing same-sex marriage.	Legalization of Same-sex Marriage
How does traditional marriage between a man and a woman equal marriage between two men or two women? It doesn't!.	Legalization of Same-sex Marriage
Same sex partners deserve the same rights others.	Legalization of Same-sex Marriage
Same-sex marriage demeans heterosexual marriage.	Legalization of Same-sex Marriage
Gay people have shown to raise children well or better like other couples.	Legalization of Same-sex Marriage
Same-sex couples should have the possibility of making a family.	Legalization of Same-sex Marriage
Same sex couples should have the same financial obligations in divorce that heterosexual couples do.	Legalization of Same-sex Marriage
Same sex marriage shouldn't be up for debate.	Legalization of Same-sex Marriage
Homosexuals should be able to adopt kids.	Legalization of Same-sex Marriage
Homosexuality is a sin.	Legalization of Same-sex Marriage
Same sex marriage should not be legalized because its againts God's will.	Legalization of Same-sex Marriage
Homosexuality is not a disease.	Legalization of Same-sex Marriage
Marriage is a holy union for man amd woman, not woman and woman or man and man.	Legalization of Same-sex Marriage
It is not ok to let children see same sex couples.	Legalization of Same-sex Marriage
Marriage is between two people not the government.	Legalization of Same-sex Marriage
Same sex Marriage childrens will be victims of bullying.	Legalization of Same-sex Marriage
There is more domestic abuse in homosexual couples.	Legalization of Same-sex Marriage
A persons sexuality does not determine if they are good parents.	Legalization of Same-sex Marriage
Singling out and denying a group to marry based upon their sexual orientation is discrimination and subsequently creates a second class of citizens.	Legalization of Same-sex Marriage
Legalization of same sex marriage are good for LGBT community.	Legalization of Same-sex Marriage
Same sex marriage doesn't affect ones parenting style.	Legalization of Same-sex Marriage
Marriage should only be between a man and a woman.	Legalization of Same-sex Marriage
Legalization of same sex marriage should be approved because it's their choice.	Legalization of Same-sex Marriage
Marriage is a religious commitment.	Legalization of Same-sex Marriage
Everyone deserves the freedom to commit themselves to their partner.	Legalization of Same-sex Marriage
Marriage is an internationally recognized human right for all people.	Legalization of Same-sex Marriage
The biological part should play major role in taking decisions on same sex-marriage.	Legalization of Same-sex Marriage
All of age and sound mind human beings should be able to choose freely to whom they want to marry. it is not a choice for the government to limit.	Legalization of Same-sex Marriage
Same sex marriages should not be denied and marriage is marriage regardless.	Legalization of Same-sex Marriage
Saying that gay people should get married is like saying that a brother can marry his sister  both are at higher risk of disease.	Legalization of Same-sex Marriage
Same sex marriage is unlike any other marriage.	Legalization of Same-sex Marriage
Same-sex marriage undermines the institution of marriage that has traditionally been defined as being between a man and a woman.	Legalization of Same-sex Marriage
Children of same-sex couples will turn out gay.	Legalization of Same-sex Marriage
Gay couple shouldn't be discriminated.	Legalization of Same-sex Marriage
Allow same sex couple.	Legalization of Same-sex Marriage
Homosexual marriage is not somthing out of the norms.	Legalization of Same-sex Marriage
Same-sex couples should have their rights protected by the government.	Legalization of Same-sex Marriage
Same-sex marriage is consistent with homosexuality which is immoral and unnatural.	Legalization of Same-sex Marriage
Love is a right for everyone.	Legalization of Same-sex Marriage
Same sex marriage is relative to people's culture and belief.	Legalization of Same-sex Marriage
Same-sex couples should have the same duties as heterosexuals marriages.	Legalization of Same-sex Marriage
Same sex couples should have the same financial benefits as other couples.	Legalization of Same-sex Marriage
Same sex couples should have the same benefits as heterosexual couples.	Legalization of Same-sex Marriage
Gay couples who want to raise children should have the same rights as opposite sex couples.	Legalization of Same-sex Marriage
Same-sex couples have the right to be happy.	Legalization of Same-sex Marriage
Same sex couple love just as do everyone else and are entitled the right to the same benefits as other human beings.	Legalization of Same-sex Marriage
Same-sex marriage undermines the institution of marriage that has traditionally been defined as a being between a man and a woman.	Legalization of Same-sex Marriage
Gay couples should have the same basic human rights as other people.	Legalization of Same-sex Marriage
Marriage is for procreation and should not be extended to same-sex couples.	Legalization of Same-sex Marriage
Gay couples should not be able to adopt a child because it would be confusing for a child.	Legalization of Same-sex Marriage
Denying some people the option to marry is discriminatory.	Legalization of Same-sex Marriage
Legalizing same sex marriage protects marriage.	Legalization of Same-sex Marriage
Making committed human connections is good for physical and mental health.	Legalization of Same-sex Marriage
Same-sex marriage does not take away from the important message of marriage.	Legalization of Same-sex Marriage
Gay couples have relationships just like heterosexual couples.	Legalization of Same-sex Marriage
Civil unions and domestic partnerships afford many of the rights of marriage thus marriage should not be expanded to include same-sex couples.	Legalization of Same-sex Marriage
Same sex couples should have to same rights as everyone else.	Legalization of Same-sex Marriage
There are consequences for children of same-sex marriages as children need to have a male father and female mother.	Legalization of Same-sex Marriage
God loves all the people for equal.	Legalization of Same-sex Marriage
Marriage has always been between a man and a woman.	Legalization of Same-sex Marriage
Marriage should be a choice for everyone.	Legalization of Same-sex Marriage
It is not natural for two people of the same gender to be married.	Legalization of Same-sex Marriage
Same sex marriage will benefit society because couples can depend on each other for social security and recognition of status.	Legalization of Same-sex Marriage
Homosexuality is not a choice and should not be treated as one.	Legalization of Same-sex Marriage
Same sex marriage is the same as heterosexual marriage and should not be treated differently.	Legalization of Same-sex Marriage
Same-sex marriages should be accepted by churches.	Legalization of Same-sex Marriage
Gay people deserve the right to marry.	Legalization of Same-sex Marriage
It is discriminatory to deny same-sex couples options to marry.	Legalization of Same-sex Marriage
Same-sex marriage is marriage between two people who love one another.	Legalization of Same-sex Marriage
Same sex marriage promotes stability of same sex relationships the same as heterosexual couples.	Legalization of Same-sex Marriage
Same sex couples are human beings and must be able to fulfill their desires.	Legalization of Same-sex Marriage
Marriage of gay couples provides a more stable environment for raising children.	Legalization of Same-sex Marriage
Homosexuals make good parents.	Legalization of Same-sex Marriage
There is no evidence that opposite-sex couples make better parents than same-sex couples.	Legalization of Same-sex Marriage
Gay couples could love each other more than a heterosexual couple.	Legalization of Same-sex Marriage
Its not my buisness who you choose to be with.	Legalization of Same-sex Marriage
Gay couples are more than capable of providing good homes to needy children.	Legalization of Same-sex Marriage
Homosexuals are good parents.	Legalization of Same-sex Marriage
Civil union is not equal to marriage.	Legalization of Same-sex Marriage
Marriage is just a piece of paper.	Legalization of Same-sex Marriage
Same sex marriage should share thesame  benefits with other forms of marriage.	Legalization of Same-sex Marriage
Churches should be able to not allow same sex marriages as part of their rights.	Legalization of Same-sex Marriage
Marriage is a basic human right.	Legalization of Same-sex Marriage
Climate change will make areas of the world uninhabitable within this decade.	Climate Change
The way to treat climate change is by reducing the amount of fossil fuel that is burnt.	Climate Change
Decreasing human water supplies, increased fire frequency, ecosystem change and expanded deserts.	Climate Change
Humans are the cause of pollution which enable climate change.	Climate Change
Climate change will reach a point where there is nothing we can do about it.	Climate Change
Global warming has nothing to do with the change in weather.	Climate Change
Climate change is affecting animals homes.	Climate Change
Extreme weather patterns are part of climate change.	Climate Change
Climate change can be reversed with effort.	Climate Change
Climate change has a lot of research that it is real.	Climate Change
There has been an increase in tropical storms of greater intensity which can be attributed to climate change.	Climate Change
The use of fossil fuels in excess has contributed to climate change.	Climate Change
The high rate of fossil fuels is causing climate change.	Climate Change
Global warming will be solved by technology innovations.	Climate Change
Economic damage to poorer, low latitude countries.	Climate Change
There is not a real contribution of human activitis in Climate change.	Climate Change
Climate change needs to be addressed.	Climate Change
The ice caps are currently melting leading to increases in sea level.	Climate Change
The climate change is caused by most developed country.	Climate Change
Glacier are melting at unprecedented rates due to global warming, causing additional climate change.	Climate Change
Climate change cannot be blamed for every weather phenomenon.	Climate Change
Humans are responsible for the rise in temperatures.	Climate Change
Climate change is already costing money.	Climate Change
People should do their part to protect nature and avoid climate change.	Climate Change
Advertising campaigns that encourage the preservation of the environment.	Climate Change
Hurricanes are due to climate change.	Climate Change
The rising risk of climate change should not be ignored.	Climate Change
Human beings are primarily responsible for global warming.	Climate Change
Humans do not have that large of an impact.	Climate Change
Climate change has always been around.	Climate Change
The ice caps are shrinking at an alarming rate.	Climate Change
Climate change is affected by different human actions.	Climate Change
Climate change is a danger to everything living on Earth.	Climate Change
Climate change is deemed a fact by the scientific community.	Climate Change
Irresponsible acts such as air pollutants, chemicals and human impact erosion contribute to climate change.	Climate Change
Climate change is affecting the polar ice caps.	Climate Change
Stop killing trees will prevent climate change.	Climate Change
Car exhausts can change our climate.	Climate Change
Global warming is a naturally occurring phenomenon unrelated to human activity.	Climate Change
Government should do something to avoid climate change.	Climate Change
Human activity need to be revised to change the effects of climate change.	Climate Change
There are signs of global warming happening all over the world.	Climate Change
Earth's climate is a cycle of change as seen through ice ages and warming periods, in which we are currently in a warming period.	Climate Change
Climate change increases the occurrence of allergic symptoms due to rise in allergenic pollen.	Climate Change
Climate change is responsible for the deaths of polar bears.	Climate Change
Climate change is caused by bad people.	Climate Change
Humans can effect climate change.	Climate Change
Humans are not responsible for climate change.	Climate Change
Climate change increases the likelihood of some diseases.	Climate Change
We should believe in scientists who are experts in the matter.	Climate Change
People should act now to protect earth and avoid climate change.	Climate Change
Global warming is just a strategy to get people to recycle more.	Climate Change
Human activity is primarily responsible for global climate.	Climate Change
Many people are not aware of the damage caused by climate change on planet earth.	Climate Change
Climate Change is accelerated by changes in atmospheric concentration of green house effect.	Climate Change
Climate change is responsible for melting glaciers.	Climate Change
People play a huge factor in global warming.	Climate Change
Climate change may also result in cooler weather in some areas.	Climate Change
Climate change is real.	Climate Change
The US should do something about climate change.	Climate Change
Sea levels have already risen in response to climate change.	Climate Change
Decline in rice yields due to warmer nighttime minimum temperatures.	Climate Change
Climate change result in radom rainfall.	Climate Change
Increased hurricane activity and other extreme weather evenys are a result of natural weather patterns not human -caused climate change.	Climate Change
Gas flaring can change our climate.	Climate Change
Climate change causes huge weather occurances.	Climate Change
There will be more rainfall due to climate change.	Climate Change
Polar ice caps melting is due to global warming.	Climate Change
Climate change is costing lives.	Climate Change
Deep ocean currents not human activity or a primary driver of natural climate warming and cooling cycle.	Climate Change
CO2 Levels may be controlled with more trees to prevent climate change.	Climate Change
Climate change is affecting everyone.	Climate Change
People should expect to see more volatile weather patterns resulting from climate change.	Climate Change
Rising of sea temperatures supports climate change.	Climate Change
Climate change is bad.	Climate Change
Natural changes in the sun's activity cannot explain 20th century global warming.	Climate Change
We will see spread in mosquite-borne diseases such as Malaria and Dengue Fever.	Climate Change
Global warming is not real.	Climate Change
Climate change is currently affecting the lives and livelihood of people globally.	Climate Change
Climate change has a big affect on the Earth.	Climate Change
Climate change is serious matter.	Climate Change
Scientific data from the last 100 years have shown climate change to be a fact.	Climate Change
Extremes in climate change can cause fammine, flooding, lack of water and other weather phenomena.	Climate Change
Climate change was made up by the government to keep people in fear.	Climate Change
Climate change causes hotter temperatures.	Climate Change
CO2 emissions are not the only cause for climate change.	Climate Change
The current Climate change is a natural phenomenon.	Climate Change
The change in climate can result from human activities.	Climate Change
Climate Change results in billions of dollars of damage to public infrastructure.	Climate Change
Climate change is caused by humans.	Climate Change
Climate change could be caused my human factors.	Climate Change
Climate change endangers people's health.	Climate Change
We must stop destroying ozone to prevent climate change.	Climate Change
With earths population growing more of the rainforest are being developed and destroyed adding to climate change.	Climate Change
Human activity is primarily responsible for global climate change.	Climate Change
Humans should do all they can to stop climate change.	Climate Change
It is not rising CO2 leels that are the only cause of climate change but certain instances do add to accelerating such.	Climate Change
Man has contributed to climate change.	Climate Change
Humans are not the only animals that cause pollution on this planet that results in climate change.	Climate Change
Climate change is already costing lives.	Climate Change
People are responsible for climate change.	Climate Change
Climate change endangers lives.	Climate Change
Global warming can be treated.	Climate Change
Human produced co2 is re-absorbed by oceans,forests, and other carbon sinks negating any climate changes.	Climate Change
We can see strange weather patterns around the world which is a strong indicator of climate change.	Climate Change
Climate change is destroying the habitat of animals who depend on consistently cold environments.	Climate Change
High rate of emission is causing climate change.	Climate Change
Trump won the election due to his positions on the environment.	Climate Change
Al Gore should practice what he preaches - or go away.	Climate Change
Climate change will cause problems for future generations.	Climate Change
The Bible talks about climate change.	Climate Change
Climate change research shows that it affects us and the earth negatively.	Climate Change
If we do not decrease pollution it will exacerbate climate change.	Climate Change
We are experiencing more extreme weather in recent years.	Climate Change
Preventing activities that cause climate change can prevent further damage.	Climate Change
Species of flora and fauna have disappeared due to climate change issues.	Climate Change
Climate change has cost at least thirty lives from Hurricane Harvey.	Climate Change
Oceans rise due to climate change.	Climate Change
We are still unsure what could cause climate change.	Climate Change
Humanity holds key responsibility for combating climate change.	Climate Change
Other countries, such as China, are worse for the environment than the US.	Climate Change
Climate change extremes are being experienced more regularly in the current century.	Climate Change
People and environment as well as animals have been affected by climate change.	Climate Change
Moving to electrical cars wil stop climate change.	Climate Change
The climate is in a constant cycle and we are currently in a warming period.	Climate Change
Some climate change is part of the earths natural cycle and cannot be blamed on mankind.	Climate Change
Climate change will cause food shortages.	Climate Change
Global warming is the rise in the temperature of the Earth's.	Climate Change
Climate change is leading to some animals dying off.	Climate Change
The sea levels are rising due to climate change.	Climate Change
Different changes in weather does not mean global warming.	Climate Change
Climate change will adversely affect third world countries the most.	Climate Change
Climate change should be examined.	Climate Change
Earth's climate has always warmed and cooled.	Climate Change
Rising levels of atmospheric CO2 do not necessarily cause global warming.	Climate Change
A solution to climate change must be sought soon.	Climate Change
Global warming can change our climate.	Climate Change
Use of certain aerosol substances accelerates global warming.	Climate Change
Climate change is causing flooding due to melting ice caps.	Climate Change
Animals have no responsibility for climate change.	Climate Change
Reducing greenhouse gas emissions will not necessarily stop climate change.	Climate Change
Global warming has been showcased with increased temperatures in dry areas.	Climate Change
The country already has too much debt to even consider funding healthcare.	Obama Care -- Affordable Health Care Act
Obama care should not be scrapped.	Obama Care -- Affordable Health Care Act
No one should be deprived of health care.	Obama Care -- Affordable Health Care Act
All people should have right to a safe life.	Obama Care -- Affordable Health Care Act
Obama Care makes people use cheap medicine.	Obama Care -- Affordable Health Care Act
Healthcare is too expensive.	Obama Care -- Affordable Health Care Act
Unemployed must revice free Health care.	Obama Care -- Affordable Health Care Act
Obamacare should not exist.	Obama Care -- Affordable Health Care Act
A benefit of unregulated health care is lower cost of medicine although it will not be available without health care.	Obama Care -- Affordable Health Care Act
You should not be fined if you don’t have insurance.	Obama Care -- Affordable Health Care Act
Health coverage should be optional.	Obama Care -- Affordable Health Care Act
The affordable health care act causes an increase in health care costs.	Obama Care -- Affordable Health Care Act
Preventative care is beneficial for the entire health care system.	Obama Care -- Affordable Health Care Act
It is the humane thing to do to provide healthcare for those that cannot afford it.	Obama Care -- Affordable Health Care Act
Medical treatments should be free for all the people.	Obama Care -- Affordable Health Care Act
Everyone should receive healthcare.	Obama Care -- Affordable Health Care Act
Because of obama care an increased number of americans have health insurance.	Obama Care -- Affordable Health Care Act
With obamacare tens of millions of uninsured people have access to affordable, high-quality health insurance through Medicaid expansion, their employers, and the Health Insurance Marketplace.	Obama Care -- Affordable Health Care Act
People may rely on free health care to substitute there own role in maintaining unhealthy lifestyle choices.	Obama Care -- Affordable Health Care Act
The premiums for the Affordable Care Act are too expensive.	Obama Care -- Affordable Health Care Act
Health care should be offered to all with a doctor determining to end a patients care for negative reasonings.	Obama Care -- Affordable Health Care Act
All americans should get the same health insurance that congress gets.	Obama Care -- Affordable Health Care Act
Free health care is just another entitlement.	Obama Care -- Affordable Health Care Act
Saving a life should be a top priority regardless of health care.	Obama Care -- Affordable Health Care Act
The middle class should have to pay higher taxes, because they will use more government funds for their healthcare.	Obama Care -- Affordable Health Care Act
Free market capitalism doesn't work for health care, because a person who is keeling over from a heart attack doesn't have time to select the best hospital with the most affordable cost.	Obama Care -- Affordable Health Care Act
Health Care should be self paid but subsidiate by the goverment.	Obama Care -- Affordable Health Care Act
Obama Care helps thousands of individuals get the care they deserve.	Obama Care -- Affordable Health Care Act
Universal health care is too slow.	Obama Care -- Affordable Health Care Act
Medicines should regulate their price or be free in hospitals.	Obama Care -- Affordable Health Care Act
Government needs to make people healthy.	Obama Care -- Affordable Health Care Act
Other countries with free healthcare have a cheaper system that works equally good.	Obama Care -- Affordable Health Care Act
All citizens should benefits from obama care.	Obama Care -- Affordable Health Care Act
Affordable Health Care Act should not be replaced.	Obama Care -- Affordable Health Care Act
Every person has the right to access basic medical care.	Obama Care -- Affordable Health Care Act
Healthcare professionals should not suffer with no health insurance and not be charged for it either.	Obama Care -- Affordable Health Care Act
Things to save people life should be offered freely to them.	Obama Care -- Affordable Health Care Act
Free market on drugs lets people raise the price.	Obama Care -- Affordable Health Care Act
Affordable Health Care Act is good for the country.	Obama Care -- Affordable Health Care Act
Obama care should and has end the dropping sick patients.	Obama Care -- Affordable Health Care Act
In its current form, the Affordable Care Act is not sustainable.	Obama Care -- Affordable Health Care Act
Obama care is bad for the country.	Obama Care -- Affordable Health Care Act
Some regulations on healthcare and drug pricing is necessary to ensure access to both without economic disaster from price gouging.	Obama Care -- Affordable Health Care Act
Having access to health care makes the population more secure.	Obama Care -- Affordable Health Care Act
Obama care should be encouraged.	Obama Care -- Affordable Health Care Act
The law also includes spending. Upfront spending and more regulation are required to realize long-term cost-curbing measures.	Obama Care -- Affordable Health Care Act
People shouldn't die because they can't afford the cure.	Obama Care -- Affordable Health Care Act
Obama care is a waste of money.	Obama Care -- Affordable Health Care Act
By giving people free health care it can lead to them being lazy.	Obama Care -- Affordable Health Care Act
Healthcare is the basis of living.	Obama Care -- Affordable Health Care Act
Life should not be only for wealthy as wealthy people are no better than those less fortunate.	Obama Care -- Affordable Health Care Act
Free health care is very necessary for certain social groups.	Obama Care -- Affordable Health Care Act
Obama care should subsidiate expensives medicines.	Obama Care -- Affordable Health Care Act
We should get rid of the health insurance middle man.	Obama Care -- Affordable Health Care Act
Obama care should be removed.	Obama Care -- Affordable Health Care Act
There should be more competitive prices for health care.	Obama Care -- Affordable Health Care Act
A low cost medicine pogram help to improve Heatl care.	Obama Care -- Affordable Health Care Act
Health care should be free for all.	Obama Care -- Affordable Health Care Act
The government must run the expenses of the sick.	Obama Care -- Affordable Health Care Act
Obamacare is of benefit to society.	Obama Care -- Affordable Health Care Act
Us citizen health care should be free for unemployed poppulation.	Obama Care -- Affordable Health Care Act
Obama care can do good in the world.	Obama Care -- Affordable Health Care Act
Medical treatments should be only for people that can afford treatments.	Obama Care -- Affordable Health Care Act
Our health care system is inefficient.	Obama Care -- Affordable Health Care Act
Affordable Health Care Act should remain in the US.	Obama Care -- Affordable Health Care Act
All americans should have free basic medical care.	Obama Care -- Affordable Health Care Act
Public health is a necessity.	Obama Care -- Affordable Health Care Act
Every one should be treated equally.	Obama Care -- Affordable Health Care Act
With obamacare nobody has to die because they have no money.	Obama Care -- Affordable Health Care Act
Healthcare should be available to all us citizens.	Obama Care -- Affordable Health Care Act
Everyone needs insurance.	Obama Care -- Affordable Health Care Act
Health care results from our right to life.	Obama Care -- Affordable Health Care Act
Health care must be accessible to low-income people.	Obama Care -- Affordable Health Care Act
Unregulated health care markets are not beneficial to the american public, they create pricing gouges for certain life saving drugs, ie the epi pens.	Obama Care -- Affordable Health Care Act
All people deserve access to health care.	Obama Care -- Affordable Health Care Act
The first step toward Universal Health Care is Obama Care, backed by the Affordable Care Act.	Obama Care -- Affordable Health Care Act
Once you give people free health care, you cannot take it back.	Obama Care -- Affordable Health Care Act
Health insurance with obamacare is now more affordable for many people.	Obama Care -- Affordable Health Care Act
Health care should be more affordable.	Obama Care -- Affordable Health Care Act
We need a enlightenment pass on Obama care.	Obama Care -- Affordable Health Care Act
Individuals living in poverty deserve health care, and Obama Care helps to make it happen.	Obama Care -- Affordable Health Care Act
Employment status should not be tied to access to health care.	Obama Care -- Affordable Health Care Act
Health care should be guaranteed for all Americans.	Obama Care -- Affordable Health Care Act
Everyone should have access to basic medical care.	Obama Care -- Affordable Health Care Act
Pre-existing conditions should be covered.	Obama Care -- Affordable Health Care Act
Having health insurance lowers medical costs.	Obama Care -- Affordable Health Care Act
Obama Care should remain the law of the federal government, as it covers more indivdiuals.	Obama Care -- Affordable Health Care Act
All healthcare should be free.	Obama Care -- Affordable Health Care Act
We should have lower prescription drug costs.	Obama Care -- Affordable Health Care Act
Access to basic medical care will lower the total overall cost for everyone.	Obama Care -- Affordable Health Care Act
Letting a person die for not having to pay for their medicine is a form of murder.	Obama Care -- Affordable Health Care Act
Everyone should be provided basic health care.	Obama Care -- Affordable Health Care Act
An unregulated market ensures cheap medicine.	Obama Care -- Affordable Health Care Act
Obama care makes many people pay higher premiums.	Obama Care -- Affordable Health Care Act
Health insurance should be cheaper for people who are healthy for their age.	Obama Care -- Affordable Health Care Act
Free health care leads to people not taking care of their health.	Obama Care -- Affordable Health Care Act
The Obama care program is too costly.	Obama Care -- Affordable Health Care Act
Healthcare should not be free for unemployed people.	Obama Care -- Affordable Health Care Act
Obacamacare provides healhtcare for all.	Obama Care -- Affordable Health Care Act
Business should not determine how much a person should suffer for medicine.	Obama Care -- Affordable Health Care Act
Every deserves a chance at life.	Obama Care -- Affordable Health Care Act
All people should have access to medicines.	Obama Care -- Affordable Health Care Act
Let the poor have a good healthcare.	Obama Care -- Affordable Health Care Act
Life saving drugs should be free for everyone.	Obama Care -- Affordable Health Care Act
Life saving drugs should be afforable for everyone.	Obama Care -- Affordable Health Care Act
The Obama care program should be revised.	Obama Care -- Affordable Health Care Act
Healthcare should be handled on the state level, not on the federal level.	Obama Care -- Affordable Health Care Act
Drugs that help save lives should be accessible.	Obama Care -- Affordable Health Care Act
Us citizens must be charged but on a mimimal level.	Obama Care -- Affordable Health Care Act
Health care should be free for everyone.	Obama Care -- Affordable Health Care Act
The poor should have a chance.	Obama Care -- Affordable Health Care Act
Our curent healthcare system is outrageous.	Obama Care -- Affordable Health Care Act
No Time Limits on Care.	Obama Care -- Affordable Health Care Act
Health must be a right of all people.	Obama Care -- Affordable Health Care Act
The wealthier you are, the more you should have to pay to help fellow Americans.	Obama Care -- Affordable Health Care Act
Affordable Health Care Act is good for all.	Obama Care -- Affordable Health Care Act
A persons life should be more important than their capability to pay for it.	Obama Care -- Affordable Health Care Act
Health care should be offered to anyone in need.	Obama Care -- Affordable Health Care Act
Health care should be accessible for everyone regardless of monetary status.	Obama Care -- Affordable Health Care Act
There are now more private coverage options, and all major medical coverage options must provide minimum essential coverage.	Obama Care -- Affordable Health Care Act
The Obama care program has to many loopholes.	Obama Care -- Affordable Health Care Act
People should have access to lifesaving medical opportunities.	Obama Care -- Affordable Health Care Act
Government needs to keep people healthy.	Obama Care -- Affordable Health Care Act
People should not be taxed for being poor.	Obama Care -- Affordable Health Care Act
Obama care is beneficial for blacks and all races other than white.	Obama Care -- Affordable Health Care Act
Health should be free for all unemployed people.	Obama Care -- Affordable Health Care Act
Everyone should have access to cheap healthcare.	Obama Care -- Affordable Health Care Act
Global health should be our primary goal.	Obama Care -- Affordable Health Care Act
Government involvement is important for a good health care.	Obama Care -- Affordable Health Care Act
With Obamacare people with pre-existing health conditions can no longer be denied coverage by insurance companies.	Obama Care -- Affordable Health Care Act
Obamacare must make sure that health concerns are treated with utmost priority.	Obama Care -- Affordable Health Care Act
Medical care should be a human right.	Obama Care -- Affordable Health Care Act
People who are paying for healthcare suffer.	Obama Care -- Affordable Health Care Act
Healthcare professionals should not have to pay taxatoin of medicaid.	Obama Care -- Affordable Health Care Act
ObamaCare’s many protections ensure that you can’t be dropped from coverage when you get sick or make an honest mistake on your application.	Obama Care -- Affordable Health Care Act
The pricing models of obama care are too expensive.	Obama Care -- Affordable Health Care Act
Cancer treatment should be subsidized.	Obama Care -- Affordable Health Care Act
Healthcare should be free for all.	Obama Care -- Affordable Health Care Act
Health care should be universal in the United States.	Obama Care -- Affordable Health Care Act
Health care should not punish people for pre-existing conditions.	Obama Care -- Affordable Health Care Act
Taxes are going up as a result of the ACA.	Obama Care -- Affordable Health Care Act
CHIP has expanded to cover up to 9 million children.	Obama Care -- Affordable Health Care Act
Access to preventative medicine reduces more expensive medical costs later.	Obama Care -- Affordable Health Care Act
Heath care access is important in leveling the playing field between classes.	Obama Care -- Affordable Health Care Act
People should pay to mantain good health.	Obama Care -- Affordable Health Care Act
Cheap medicine is accessible to those who need it.	Obama Care -- Affordable Health Care Act
Affordable Health Care Act is affordable.	Obama Care -- Affordable Health Care Act
It is good that young adults can stay on their parents’ plans.	Obama Care -- Affordable Health Care Act
Healthcare should be free.	Obama Care -- Affordable Health Care Act
More screenings should be covered in obamacare.	Obama Care -- Affordable Health Care Act
Subsidies for health insurance should be reduced at the top end of the spectrum.	Obama Care -- Affordable Health Care Act
The health care act is a very good system.	Obama Care -- Affordable Health Care Act
Health is wealth and should be encouraged.	Obama Care -- Affordable Health Care Act
Obama care should provide a measure for free health care.	Obama Care -- Affordable Health Care Act
Journalists should always present both sides of an issue equally.	Media Bias
The information must be shown in the media bluntly.	Media Bias
Thanks to our free media, we have a free world perspective.	Media Bias
A journalist must avoid biasing news.	Media Bias
Journalists intentionally report news in a way that makes republicans look bad.	Media Bias
Bias is part of human nature.	Media Bias
There are already too many yellow publishing houses.	Media Bias
If you dont like one media then consume another.	Media Bias
Reporters lie a lot.	Media Bias
The media no longer provide immediate and truthful information.	Media Bias
There should be better enforcement in the laws that go with journalism and mainstream media.	Media Bias
Journalists often report lies unintentionally.	Media Bias
Everybody is biased.	Media Bias
The society deserves the truth.	Media Bias
Media needs to present the facts.	Media Bias
Some media only project their strict bias and it hurts a majority of people i.e. fox news.	Media Bias
Journalists should report facts.	Media Bias
Mainstream media is now in support of political propagands.	Media Bias
Fox News is the only unbiased news source.	Media Bias
Journalist should not be manipulated by politicians.	Media Bias
The articles should have a subjective view.	Media Bias
So many stories are based on what type of story a politician want.	Media Bias
Sometimes reporters lie intentionally.	Media Bias
Media needs to be closely monitored by the public.	Media Bias
Mainstream media is not doing what its suppose to do.	Media Bias
The job of a reporter is to tell the truth.	Media Bias
Bias in journalism can never be completely eliminated.	Media Bias
Journalist should be upright.	Media Bias
Bias may be part of human nature but it can still be mediated to not blatantly show in media.	Media Bias
The truth should be spoken no matter the price.	Media Bias
Lower more fragmented reach and lower rated programs than network TV.	Media Bias
They have to have policies and punishments for fake news people.	Media Bias
Media bias will never go away.	Media Bias
Media bias is mostly about celebrities.	Media Bias
Media has the power to influence the audience, but often is not used for good.	Media Bias
Too many networks show biased news.	Media Bias
Media is biased in favor of the left.	Media Bias
A newscast should not be obvious what the political leanings of the journalist(s) is/are.	Media Bias
Media should be unbiased.	Media Bias
Freedom of the press prevents the government or other third parties from controlling the media.	Media Bias
It is easy to find media coverage that supports your opinion.	Media Bias
Journalist should follow the journalist creed.	Media Bias
The truth will set us free.	Media Bias
Journalists only cover stories that support their own opinion.	Media Bias
Most of the media is geared towards a specific audience making it very biast.	Media Bias
News should be unbiased.	Media Bias
Some reporters are too aggressive.	Media Bias
Common sense helps in looking beyond media bias.	Media Bias
Reporters have biased views like everyone else.	Media Bias
There is too much spin by the media.	Media Bias
Journalists are meant to be true to the core.	Media Bias
The media needs to present fair and balanced news.	Media Bias
News should be said the way it happened.	Media Bias
It is difficult to say if media bias has an impact on people.	Media Bias
Journalism is more about boosting ratings than getting the true story.	Media Bias
With blogs in the media and administrated via outlests, bias is part of media mainstream.	Media Bias
The main problem in the information issued by the media is corruption.	Media Bias
Is not has national level is worldwide.	Media Bias
Some media outlets adhere to journalistic teachings of avoiding bias and withholding personal opinions.	Media Bias
Journalism should be free and fair.	Media Bias
No media bias should be encouraged.	Media Bias
Dont use mainstream media if you want the truth.	Media Bias
There needs to be no third party influences in the media.	Media Bias
Media bias is why many Americans choose not to watch the news or read newspapers anymore.	Media Bias
Media bias should be prohibited.	Media Bias
Much of what is put out by the media today is sensationalized.	Media Bias
News people just want to make money.	Media Bias
Journalists have right to express their point of view.	Media Bias
Media should present multiple sides of each issue.	Media Bias
Mainstream media provides a relative objective view.	Media Bias
Using local channels can solve media bias to an extent.	Media Bias
The media are evil companies.	Media Bias
Mainstream media is very biast because they are looking for a reaction out of certain people.	Media Bias
Media is liberal biased because the liberals are right.	Media Bias
Bribes should not overtake our media.	Media Bias
False statements should be sanctioned.	Media Bias
Many journalists prioritize the business above the information.	Media Bias
You can't believe anything you see in the media anymore.	Media Bias
Journalist should be just.	Media Bias
Bias in journalism can never be completely eliminated -.	Media Bias
Fake news is not a real problem.	Media Bias
If you don't watch the media , bias isn't a problem.	Media Bias
Media bias is too little to worry about.	Media Bias
Journalists should be impartial in their news.	Media Bias
People need to get their facts straight before just going on what they hear from one source.	Media Bias
Mainstream media still provides a relatively objective view.	Media Bias
The people deserves the truth.	Media Bias
Newspapers should penalize biased writers.	Media Bias
Media should report the facts and not opinions.	Media Bias
Journalist's job is to report the truth and facts.	Media Bias
Journalists write false stories to gain readers.	Media Bias
Media bias will always be around.	Media Bias
Media alters the perception of a situation.	Media Bias
Media Bias is a real thing.	Media Bias
Most journalists are biast because that is human nature.	Media Bias
Buying a newspaper to read a fake news is a scam mode.	Media Bias
Bias in journalism can never be completely eliminate.	Media Bias
All the stories should be covered in an honest way.	Media Bias
Without free media there is no freedom.	Media Bias
A journalist's job is to report the truth to the public and should not accept gifts from any third party.	Media Bias
Journalist should not be biased.	Media Bias
Journalists should be more honest.	Media Bias
The information must be objective and not manipulated.	Media Bias
Not all people in the media provide falsifications.	Media Bias
BBC is the most moderate news source.	Media Bias
CNN is the main source of being a total left wing partisan.	Media Bias
Much of what the media puts out today cannot be trusted.	Media Bias
Mainstream media is no longer fulfilling its mandate of providing the society with insightful and honest stories.	Media Bias
Mots journalists doing a good job.	Media Bias
One should not trust the media.	Media Bias
Most journalist are dishonest people.	Media Bias
This issue is about whether media bias is a real thing.	Media Bias
Journalists should be upright.	Media Bias
The media should not be biast because it gives people the wrong impression about some things.	Media Bias
Reporters now care more about politics.	Media Bias
Journalist should not accept bribe.	Media Bias
By Biasing information journalists hurt others.	Media Bias
Journalism focusses on Democrats views.	Media Bias
Media bias declines ratings and decreases audience.	Media Bias
Too many articles covered in the mainstream media are biased and untruthful.	Media Bias
News are hard to believe.	Media Bias
All media outlets are biased.	Media Bias
Many journalists give commentary on news stories.	Media Bias
People naturally share their opinion and is not biased among journalists.	Media Bias
Sometimes news coverage is very conflicting.	Media Bias
Mainstream media is no longer fulfilling its mandate.	Media Bias
Fox News is biased in favor of the right.	Media Bias
Mainstream media is no longer fulfilling its mandate of providing the society with insightful.	Media Bias
Every body has its owns preferences.	Media Bias
Reporters often don't fully look into a topic.	Media Bias
Bias in journalism can never be completely eliminated -- bias is part of human nature.	Media Bias
Media bias is a real thing.	Media Bias
The media has become too influential in political outcomes.	Media Bias
Vaccines can end up saving childrens lives.	Mandatory Vaccination
Vaccinations should be a choice.	Mandatory Vaccination
Vaccines save people's lives.	Mandatory Vaccination
It is cruel to force someone to get an injection.	Mandatory Vaccination
Diseases are more controlled under vaccines.	Mandatory Vaccination
The people have the right to choose if they want participe in vaccination or not.	Mandatory Vaccination
Vaccination should be compulsory.	Mandatory Vaccination
Vaccines help in supporting public health.	Mandatory Vaccination
All the people have right to have all the vaccines.	Mandatory Vaccination
Vaccines can cause very harmful side effects and are not always safe.	Mandatory Vaccination
Vaccines help us live longer and protect us from fatal diseases.	Mandatory Vaccination
Vaccinations help prevent sickness.	Mandatory Vaccination
No vaccination can lead to people getting sick or even killed by a virus.	Mandatory Vaccination
Children should be vaccinated from early childhood.	Mandatory Vaccination
Vaccines do not make you develop diseases.	Mandatory Vaccination
Vaccinations increase herd immunity.	Mandatory Vaccination
Vaccination protect the young and vulnerable ones.	Mandatory Vaccination
Vaccines improve the lives of citizens.	Mandatory Vaccination
Vaccines keep us healthy.	Mandatory Vaccination
Vaccines are important for newborns.	Mandatory Vaccination
Not everyone has the chance to get vaccinated.	Mandatory Vaccination
Medical treatments like vaccines should be for all the people.	Mandatory Vaccination
People should not be forced to vaccinate.	Mandatory Vaccination
Vaccines prevent disease.	Mandatory Vaccination
Vaccinations should be mandatory for all school children.	Mandatory Vaccination
The ingredients in vaccines are unsafe in the amounts used.	Mandatory Vaccination
Vaccine ingredients are not always disclosed to patients.	Mandatory Vaccination
All people should have access to vaccines.	Mandatory Vaccination
There should be more funding for vaccination.	Mandatory Vaccination
People should be allowed to make their own decisions about medical choices for their children.	Mandatory Vaccination
A greater number of people should be vaccinated for a vaccine to be effective.	Mandatory Vaccination
Vaccines are necessary for our safety.	Mandatory Vaccination
Vaccines are well trusted science.	Mandatory Vaccination
Vaccination prevents outbreaks of easily preventable diseases.	Mandatory Vaccination
Side effects of vaccinations are rare.	Mandatory Vaccination
Vaccines should be required by law.	Mandatory Vaccination
Vaccines do not suit people with AIDS.	Mandatory Vaccination
Vaccines has to be somthing thats readilly available for people to buy.	Mandatory Vaccination
The ingredients in vaccines are safe in the small amounts they are used.	Mandatory Vaccination
Vaccine's can protect other people than yourself.	Mandatory Vaccination
Vaccines increase the risk of autism.	Mandatory Vaccination
Vaccine's can help one from getting sick.	Mandatory Vaccination
Government should leave vaccinations to medical practioners.	Mandatory Vaccination
Not vaccinating your child is unhealthy for the child and its contemporaries.	Mandatory Vaccination
Doctors and science are more educated on vaccinations than parents and religious organizations.	Mandatory Vaccination
Vaccination should be offered in school.	Mandatory Vaccination
Vaccines are necessary to tackle strong diseases.	Mandatory Vaccination
Vaccines can cause serious and fatal side effects.	Mandatory Vaccination
Vaccines prevent deadly diseases.	Mandatory Vaccination
The benefits of vaccines outweigh the risks.	Mandatory Vaccination
Must have a containment plan when a new disease is discovered.	Mandatory Vaccination
Vaccines do not suit all people (e.g. people with diabetes).	Mandatory Vaccination
Everyone should have certain recommended vaccines.	Mandatory Vaccination
Most medical doctors and other healthcare professionals are positive about what has been achieved through vaccination in preventing and eradication a number of life threatening diseases.	Mandatory Vaccination
Vaccines can have severe side effects.	Mandatory Vaccination
Vaccinations should be mandatory.	Mandatory Vaccination
Vaccines can have adverse side effects such as the disease that the vaccine is trying to prevent.	Mandatory Vaccination
Children should not be allowed in school or daycare unless vaccinated.	Mandatory Vaccination
People who are against vaccinations are not smart.	Mandatory Vaccination
Compulsory vaccination would avoid epidemics.	Mandatory Vaccination
Any method is ok to prevent major tragedies.	Mandatory Vaccination
Vaccines need to be mandatory to promote safe health.	Mandatory Vaccination
Vaccinations are expensive and yet not 100% safe.	Mandatory Vaccination
Patients have the right to know what is in vaccines.	Mandatory Vaccination
There are social and religious groups that to be educated more about vaccination.	Mandatory Vaccination
Vaccination are important for public health.	Mandatory Vaccination
Vaccines should be mandatory.	Mandatory Vaccination
Vaccines are not safe.	Mandatory Vaccination
Early vaccines are safe.	Mandatory Vaccination
Viruses like human papilloma can only be prevented with the vaccine.	Mandatory Vaccination
It is safe to use vaccines if the doctor recommends it.	Mandatory Vaccination
Vaccines should be implemented.	Mandatory Vaccination
Vaccines ensure public safety.	Mandatory Vaccination
Vaccination is good for everyone's health.	Mandatory Vaccination
Vaccines have never been proven to work.	Mandatory Vaccination
No tested vaccines are dangerous.	Mandatory Vaccination
The government should promote campaigns for vaccination.	Mandatory Vaccination
The benefits of vaccinations far outweigh the risks.	Mandatory Vaccination
Artificial immunity will compromise the body’s ability to defend itself for a long time.	Mandatory Vaccination
Some people have side effects from vaccination.	Mandatory Vaccination
Vaccination is too expensive.	Mandatory Vaccination
Vaccines are an example of where the common good outweighs individual rights.	Mandatory Vaccination
Vaccines are not the perfect solution to diseases.	Mandatory Vaccination
Vaccinations saves lives.	Mandatory Vaccination
Vaccines are crucial to make sure diseases don't start.	Mandatory Vaccination
Vaccines prevent disease outbreaks.	Mandatory Vaccination
Vaccines prevent public health epidemics.	Mandatory Vaccination
Vaccination have the risk of harmful and toxic chemicals being introduced to the body.	Mandatory Vaccination
Someone who is not vaccinated is at higher risk of getting certain diseases.	Mandatory Vaccination
Vaccinations cause autism.	Mandatory Vaccination
Vaccines can cause adverse reactions.	Mandatory Vaccination
The government should not intervene in personal medical choices.	Mandatory Vaccination
Proper vaccinations are safe.	Mandatory Vaccination
The vaccines must be given by people who are very prepared to put them.	Mandatory Vaccination
It should be a parents choice whether to vaccinate or not.	Mandatory Vaccination
Vaccine's are good for kids.	Mandatory Vaccination
Vaccine's should be mandatory for everyone.	Mandatory Vaccination
Vaccination should be mandatory at an early age.	Mandatory Vaccination
Vaccine's should be free for everyone.	Mandatory Vaccination
Vaccines are key to development in Africa.	Mandatory Vaccination
Vaccinations don't just protect individuals, they protect the whole country for diseases.	Mandatory Vaccination
The theory of herd immunity has never been proven.	Mandatory Vaccination
Vaccination must be a staple in medical benefits.	Mandatory Vaccination
There must be greater support of vaccination from medical institutes.	Mandatory Vaccination
Parents should choose whether or not to have their child vaccinated.	Mandatory Vaccination
Vaccination should be free for everyone.	Mandatory Vaccination
Some vaccines are very expensive for the public, such as HPV vaccines.	Mandatory Vaccination
Vaccines have a positive effect on people's health.	Mandatory Vaccination
Vaccination programs have been carried out extensively and have totally eradicated life threatening diseases from the human race.	Mandatory Vaccination
Vaccinations are safe.	Mandatory Vaccination
Vaccines are very helpful and very needed.	Mandatory Vaccination
The government must interfere with holistic methods that are not safe and anti vaccination.	Mandatory Vaccination
Vaccines are good for society.	Mandatory Vaccination
Vaccines are tested and proven to be safe.	Mandatory Vaccination
Vaccinations can safeguard against deadly diseases and viruses.	Mandatory Vaccination
Vaccination must be madatory.	Mandatory Vaccination
It should be mandatory for all people to get vaccines to protect those who cannot get vaccinated.	Mandatory Vaccination
Vaccinations need to be regulated.	Mandatory Vaccination
The ingredients in vaccines are safe in the amounts used.	Mandatory Vaccination
Vaccination saves lives.	Mandatory Vaccination
Vaccines should be mandatory when entering a public or private school.	Mandatory Vaccination
Mandatory vaccination should be implemented.	Mandatory Vaccination
Vaccines endagers the human race in some areas.	Mandatory Vaccination
Schools shouldn't require vaccinations.	Mandatory Vaccination
Vaccines should be free.	Mandatory Vaccination
Vaccinations prevents disease.	Mandatory Vaccination
Vaccines provide immunity against diseases.	Mandatory Vaccination
A lot of money has been saved since the advent and adoption of vaccination.	Mandatory Vaccination
Vaccines are a dirty business of pharmaceuticals.	Mandatory Vaccination
Once a child is born it must be vaccinaced.	Mandatory Vaccination
Vaccination is the administration of antigenic material.	Mandatory Vaccination
Some people are unable to receive vaccines.	Mandatory Vaccination
Vaccines prevent people from harmful diseases.	Mandatory Vaccination
People who do not vaccinate put others at a higher risk.	Mandatory Vaccination
Terrorists are recruiting people via the internet.	War on Terrorism
Terrorism has to be defeated using all available means.	War on Terrorism
The cost of terror has economical and human consequences.	War on Terrorism
American born terrorists are a bigger threat than middle eastern terrorists.	War on Terrorism
It is ok that our taxes support the war on terrorism.	War on Terrorism
Torture is sometimes required to get answers.	War on Terrorism
Terrorism should be stopped by any means necessary.	War on Terrorism
It is needed to educate people to reduce terrorism.	War on Terrorism
We need to take necessary means to capture terrorists.	War on Terrorism
We should fight to the finish against Afghanistan.	War on Terrorism
The government uses the war on terror to spy on US citizens.	War on Terrorism
The war on terror made us look a lot stronger as a nation.	War on Terrorism
We need to focus on intelligence and infiltrating groups of suspected terrorists.	War on Terrorism
War on terrorism should be the priority by the US.	War on Terrorism
US should not meddle in foreign affairs in the name of defense.	War on Terrorism
Immigration into the United States must be monitored and restricted to prevent terrorism within our borders.	War on Terrorism
We should not call it a war, as it is totally different than what we think of as a war between countries.	War on Terrorism
The United States is in more debt than ever because of the War on Terrorism.	War on Terrorism
Terrorism needs to be destroy  by using tecnology.	War on Terrorism
The economic costs of terrorism and human cost is far too much.	War on Terrorism
Fighting terrorism by using bombings that kill civilians creates more terrorists than it kills.	War on Terrorism
The government must take care that the taken measures on counter-terror does not affect innocents.	War on Terrorism
Terrorism needs to end with the hope of peace.	War on Terrorism
The war on terror makes us a police state rather than do much for our world image and sovereignt.	War on Terrorism
The CIA use the war on terror to spy on others.	War on Terrorism
Too many lives are lost during acts of terrorism.	War on Terrorism
Terrorism needs to be stopped.	War on Terrorism
Government surveillance may inadvertantly pick up info on unrelated persons.	War on Terrorism
Terrorists lose any kind of human right.	War on Terrorism
We must protect our country.	War on Terrorism
Terrorism is a war that effects the world.	War on Terrorism
The war on terrorism resulted in more terrorist acts against the United States.	War on Terrorism
The United States had to do something regarding terror following September 11, 2001.	War on Terrorism
The war against afghanistan was justified by terrorism.	War on Terrorism
The government is spending too much funds on war on terrorism.	War on Terrorism
We must have a psychological support group for many of the affected by terror.	War on Terrorism
Measures to end terrorism must be maximized.	War on Terrorism
Spying is a necessary method to prevent terrorists from acting.	War on Terrorism
The War on Terrorism is costing too much.	War on Terrorism
The war on terrorism creates more terrorism.	War on Terrorism
Torture can be used to extract necessary information.	War on Terrorism
Quit spending money overseas.	War on Terrorism
Using torture makes us terrorists.	War on Terrorism
The war on terrorism needs to be stopped.	War on Terrorism
The government uses war on terror to spy on foreign affairs.	War on Terrorism
War on terriorism kept us safe so far.	War on Terrorism
The US needs to stop their war on terrorism.	War on Terrorism
Torture may have some benefits although inhuman.	War on Terrorism
Torture should not be allowed.	War on Terrorism
Terrorism will always be ahead of authorities trying to combat it because there is no boundary too great to cross and they will do anything to achieve their results.	War on Terrorism
America should control the middle east.	War on Terrorism
War is sometimes a necessary thing.	War on Terrorism
The terrorists are very crue to telorate.	War on Terrorism
People can not avoid war.	War on Terrorism
Terrorism will be a part of our world until the end of time, that is one of the costs of freedom of thought.	War on Terrorism
Any arrested terrorist should be jailed.	War on Terrorism
It is necessary to protect ourselves from viable terrorism.	War on Terrorism
Eradicating terrorism save many lives.	War on Terrorism
The War on Terrorism did not boost the economy.	War on Terrorism
President Bush had to make a difficult decisions regarding the War on Terrorism.	War on Terrorism
We have no credible evidence that Iraq and al Qaeda cooperated on attacks against the United States.	War on Terrorism
God does not approve any war.	War on Terrorism
Terrorist should be killed without trials.	War on Terrorism
The war on terrorism is to costly.	War on Terrorism
Torture is an ineffective way to extract reliable information from people.	War on Terrorism
The US government must provide measures to prevent war.	War on Terrorism
Fighting terrorists only radicalizes more.	War on Terrorism
The United States must work with the international community to defeat terrorism.	War on Terrorism
A person's chances of being killed by a terrorist are astronomically low.	War on Terrorism
War against terrorism is expensive.	War on Terrorism
The government uses the war on terror to spy on US citizen.	War on Terrorism
The war on terrorism has lead to discrimination of muslims.	War on Terrorism
The US uses terrorism to justifice violence against other countries.	War on Terrorism
Sometimes spying on terrorists can unfortunately reveal about unrelated persons.	War on Terrorism
Too much lives are wasted because of war on terrorism.	War on Terrorism
Many companies are getting rich by selling wapons agains terrorism.	War on Terrorism
The war on terrorism must be taken serious.	War on Terrorism
The United States must appropriate adequate funds to fight terrorism internationally.	War on Terrorism
Casualties piled by the War on Terrorism are necessary to protect constitutional fundamentals.	War on Terrorism
Radical Islamic terrorists do not portray the beliefs of all muslims.	War on Terrorism
Military deployment to the Middle East is a necessary to deter terrorism.	War on Terrorism
Terrorism needs to be defeated using all available means.	War on Terrorism
Terrorism is dangerous to all the world.	War on Terrorism
Terrorism should be defeated but not at the cost of civilian lives.	War on Terrorism
The terrorist issue is small compared to other priorities.	War on Terrorism
Terrorism should not be encouraged.	War on Terrorism
Measures to be taken must be preventive to major risks.	War on Terrorism
USA need more arab people to fight terror.	War on Terrorism
Jet fuel can't melt steel beams: 9-11 is fake.	War on Terrorism
US should act seriously on terrorism war.	War on Terrorism
Troops lives have been lost for no reason due to the war on terrorism.	War on Terrorism
We will never be able to eliminate terrorism.	War on Terrorism
The War on Terror is unwinnable.	War on Terrorism
Terrorism should be countered.	War on Terrorism
Any cost is little if terrorism is eliminated.	War on Terrorism
The 9/11 attacks stunned the nation.	War on Terrorism
We should take troops out of the middle east.	War on Terrorism
Terrorism has destroyed too much and needs to end.	War on Terrorism
As a bonus, war on terror almost guarantees safety worldwide.	War on Terrorism
The war on terrorism is an invasion of privacy.	War on Terrorism
The war or terrorism must be enforced and take seriously.	War on Terrorism
The War on Terrorism required a large amount of funding to be.	War on Terrorism
If U.S. citizens have nothing to hide, then they shouldn't be concerned about the government spying on them.	War on Terrorism
The war on terror kept us safe so far.	War on Terrorism
Terrorism is the biggest problem of our time.	War on Terrorism
The War on Terrorism was a necessary defense measure.	War on Terrorism
War on terrorism is good for the country.	War on Terrorism
The war on terrorism has caused more harm to us citizens.	War on Terrorism
Terrorism must be defeated.	War on Terrorism
War on terrorism is a necessary strategy.	War on Terrorism
Terrorism is only a problem in the middle east.	War on Terrorism
The war on terror having long-term economic effects while we could keep our borders safe here instead.	War on Terrorism
Torture is a necessary tool in the war on terror.	War on Terrorism
The government should have many strategies for the war.	War on Terrorism
Torture can be a necessary tool in the war on terror.	War on Terrorism
All suspected individual should be well detaned.	War on Terrorism
It is necessary to defeat the evils that want to destroy others as their mission.	War on Terrorism
The war on terrorism does not prevent terrorism.	War on Terrorism
The war on terrorism has been minimally effective.	War on Terrorism
Government need to increase fighting measure.	War on Terrorism
Measure put in place to allow government more access to private information after the 9-11 terrorist attacks have been mis used.	War on Terrorism
Terrorism takes many forms and is home grown through the use of the internet and a section of the population that is completely disenfranchised with our society.	War on Terrorism
The government is trying to use the war on terrorism to scare people.	War on Terrorism
The war on terrorism is too expensive.	War on Terrorism
The war against Afghanistan was justified by terrorism.	War on Terrorism
The us government need to spot out all the terrorist with intellegence.	War on Terrorism
We must fight for our freedoms.	War on Terrorism
All Muslims are terrorists.	War on Terrorism
More countries should join forces in combating terrorist.	War on Terrorism
Terrorism is an international threat.	War on Terrorism
The war on terror costs too much.	War on Terrorism
Terrorism should be stopped.	War on Terrorism
Terrorism needs to be eliminated once and for all.	War on Terrorism
We use the word terrorist for groups that attack us, and rebels if they attack our enemies.	War on Terrorism
